data,região,instituição,1as_consultas,consultas_subsequentes,total_consultas,ano,mês,coordenadas,código_região
2013-01-01,Região de Saúde do Alentejo,"Unidade Local de Saúde do Norte Alentejano, EPE",90,100,190,2013,1,"-7.4263845,39.3003425",4
2013-01-01,Região de Saúde do Centro,"Centro Hospitalar do Baixo Vouga, EPE",38,49,87,2013,1,"-8.6543716,40.6362453",2
2013-01-01,Região de Saúde do Centro,"Unidade Local de Saúde da Guarda, EPE",27,5,32,2013,1,"-7.2734793,40.5309916",2
2013-01-01,Região de Saúde Norte,"Unidade Local de Saúde de Matosinhos, EPE",184,0,184,2013,1,"-8.6745115,41.1794456",1
2013-02-01,Região de Saúde do Alentejo,"Hospital Espírito Santo de Évora, EPE",185,113,298,2013,2,"-7.9032848,38.5684861",4
2013-02-01,Região de Saúde do Alentejo,"Unidade Local de Saúde do Litoral Alentejano, EPE",0,0,0,2013,2,"-8.6956768,38.0162314",4
2013-02-01,Região de Saúde do Centro,"Centro Hospitalar Tondela-Viseu, EPE",65,43,108,2013,2,"-8.0827433,40.516364",2
2013-03-01,Região de Saúde do Alentejo,"Unidade Local de Saúde do Baixo Alentejo, EPE",12,8,20,2013,3,"-7.8721227,38.014123",4
2013-03-01,Região de Saúde do Alentejo,"Unidade Local de Saúde do Litoral Alentejano, EPE",0,0,0,2013,3,"-8.6956768,38.0162314",4
2013-03-01,Região de Saúde do Centro,"Unidade Local de Saúde da Guarda, EPE",68,12,80,2013,3,"-7.2734793,40.5309916",2
2013-03-01,Região de Saúde do Centro,"Unidade Local de Saúde de Castelo Branco, EPE",28,20,48,2013,3,"-7.4981271,39.8212263",2
2013-03-01,Região de Saúde LVT,"Hospital Professor Doutor Fernando Fonseca, EPE",0,0,0,2013,3,"-9.2264834,38.7422257",3
2013-04-01,Região de Saúde do Centro,"Centro Hospitalar Universitário Cova da Beira, EPE",85,40,125,2013,4,"-7.4922407,40.2804158",2
2013-05-01,Região de Saúde do Algarve,"Centro Hospitalar Universitário do Algarve,EPE",272,60,332,2013,5,"-7.9281554,37.0238973",5
2013-06-01,Região de Saúde do Alentejo,"Hospital Espírito Santo de Évora, EPE",564,298,862,2013,6,"-7.9032848,38.5684861",4
2013-06-01,Região de Saúde do Centro,"Centro Hospitalar e Universitário de Coimbra, EPE",905,668,1573,2013,6,"-8.4098211,40.2191523",2
2013-06-01,Região de Saúde do Centro,"Unidade Local de Saúde da Guarda, EPE",94,23,117,2013,6,"-7.2734793,40.5309916",2
2013-06-01,Região de Saúde LVT,"Hospital Professor Doutor Fernando Fonseca, EPE",0,0,0,2013,6,"-9.2264834,38.7422257",3
2013-06-01,Região de Saúde Norte,"Unidade Local de Saúde de Matosinhos, EPE",630,0,630,2013,6,"-8.6745115,41.1794456",1
2013-07-01,Região de Saúde do Alentejo,"Unidade Local de Saúde do Litoral Alentejano, EPE",0,0,0,2013,7,"-8.6956768,38.0162314",4
2013-07-01,Região de Saúde do Algarve,"Centro Hospitalar Universitário do Algarve,EPE",394,82,476,2013,7,"-7.9281554,37.0238973",5
2013-07-01,Região de Saúde Norte,"Unidade Local de Saúde de Matosinhos, EPE",738,0,738,2013,7,"-8.6745115,41.1794456",1
2013-09-01,Região de Saúde do Alentejo,"Unidade Local de Saúde do Baixo Alentejo, EPE",35,18,53,2013,9,"-7.8721227,38.014123",4
2013-09-01,Região de Saúde do Centro,"Unidade Local de Saúde de Castelo Branco, EPE",81,56,137,2013,9,"-7.4981271,39.8212263",2
2013-10-01,Região de Saúde do Algarve,"Centro Hospitalar Universitário do Algarve,EPE",550,108,658,2013,10,"-7.9281554,37.0238973",5
2013-10-01,Região de Saúde do Centro,"Centro Hospitalar Universitário Cova da Beira, EPE",188,136,324,2013,10,"-7.4922407,40.2804158",2
2013-10-01,Região de Saúde do Centro,"Unidade Local de Saúde de Castelo Branco, EPE",90,74,164,2013,10,"-7.4981271,39.8212263",2
2013-10-01,Região de Saúde Norte,"Centro Hospitalar Trás-os-Montes e Alto Douro, EPE",468,0,468,2013,10,"-7.7515252,41.3031784",1
2013-11-01,Região de Saúde do Alentejo,"Hospital Espírito Santo de Évora, EPE",1018,507,1525,2013,11,"-7.9032848,38.5684861",4
2013-11-01,Região de Saúde do Centro,"Unidade Local de Saúde da Guarda, EPE",200,54,254,2013,11,"-7.2734793,40.5309916",2
2013-11-01,Região de Saúde LVT,"Centro Hospitalar de Setúbal, EPE",0,0,0,2013,11,"-8.8818638,38.5283754",3
2013-12-01,Região de Saúde do Alentejo,"Unidade Local de Saúde do Baixo Alentejo, EPE",53,21,74,2013,12,"-7.8721227,38.014123",4
2013-12-01,Região de Saúde do Centro,"Centro Hospitalar e Universitário de Coimbra, EPE",1832,1422,3254,2013,12,"-8.4098211,40.2191523",2
2013-12-01,Região de Saúde Norte,"Unidade Local de Saúde de Matosinhos, EPE",1309,0,1309,2013,12,"-8.6745115,41.1794456",1
2014-01-01,Região de Saúde do Centro,"Centro Hospitalar do Baixo Vouga, EPE",44,63,107,2014,1,"-8.6543716,40.6362453",2
2014-01-01,Região de Saúde do Centro,"Unidade Local de Saúde da Guarda, EPE",22,6,28,2014,1,"-7.2734793,40.5309916",2
2014-02-01,Região de Saúde do Centro,"Centro Hospitalar Universitário Cova da Beira, EPE",55,49,104,2014,2,"-7.4922407,40.2804158",2
2014-02-01,Região de Saúde do Centro,"Unidade Local de Saúde de Castelo Branco, EPE",46,21,67,2014,2,"-7.4981271,39.8212263",2
2014-02-01,Região de Saúde LVT,"Centro Hospitalar do Oeste, EPE",0,2,2,2014,2,"-9.1258493,39.4054629",3
2014-03-01,Região de Saúde do Alentejo,"Hospital Espírito Santo de Évora, EPE",334,150,484,2014,3,"-7.9032848,38.5684861",4
2014-03-01,Região de Saúde do Centro,"Centro Hospitalar Universitário Cova da Beira, EPE",86,57,143,2014,3,"-7.4922407,40.2804158",2
2014-03-01,Região de Saúde do Centro,"Centro Hospitalar do Baixo Vouga, EPE",155,145,300,2014,3,"-8.6543716,40.6362453",2
2014-03-01,Região de Saúde Norte,"Unidade Local de Saúde do Nordeste, EPE",0,0,0,2014,3,"-6.7888197,41.8056532",1
2014-04-01,Região de Saúde do Alentejo,"Unidade Local de Saúde do Baixo Alentejo, EPE",22,14,36,2014,4,"-7.8721227,38.014123",4
2014-04-01,Região de Saúde do Alentejo,"Unidade Local de Saúde do Norte Alentejano, EPE",206,360,566,2014,4,"-7.4263845,39.3003425",4
2014-04-01,Região de Saúde do Algarve,"Centro Hospitalar Universitário do Algarve,EPE",335,32,367,2014,4,"-7.9281554,37.0238973",5
2014-05-01,Região de Saúde do Centro,"Centro Hospitalar e Universitário de Coimbra, EPE",620,377,997,2014,5,"-8.4098211,40.2191523",2
2014-05-01,Região de Saúde do Centro,"Unidade Local de Saúde da Guarda, EPE",92,19,111,2014,5,"-7.2734793,40.5309916",2
2014-05-01,Região de Saúde LVT,"Centro Hospitalar do Oeste, EPE",1,7,8,2014,5,"-9.1258493,39.4054629",3
2014-05-01,Região de Saúde Norte,"Centro Hospitalar Universitário do Porto, EPE",155,0,155,2014,5,"-8.6172617,41.1472498",1
2014-06-01,Região de Saúde do Centro,"Centro Hospitalar e Universitário de Coimbra, EPE",803,549,1352,2014,6,"-8.4098211,40.2191523",2
2014-06-01,Região de Saúde do Centro,"Centro Hospitalar Tondela-Viseu, EPE",154,163,317,2014,6,"-8.0827433,40.516364",2
2014-06-01,Região de Saúde LVT,"Centro Hospitalar de Setúbal, EPE",0,0,0,2014,6,"-8.8818638,38.5283754",3
2014-06-01,Região de Saúde Norte,"Centro Hospitalar Trás-os-Montes e Alto Douro, EPE",295,0,295,2014,6,"-7.7515252,41.3031784",1
2014-07-01,Região de Saúde do Centro,"Centro Hospitalar e Universitário de Coimbra, EPE",1307,937,2244,2014,7,"-8.4098211,40.2191523",2
2014-07-01,Região de Saúde LVT,"Centro Hospitalar do Oeste, EPE",2,8,10,2014,7,"-9.1258493,39.4054629",3
2014-07-01,Região de Saúde LVT,"Hospital Professor Doutor Fernando Fonseca, EPE",0,0,0,2014,7,"-9.2264834,38.7422257",3
2014-07-01,Região de Saúde Norte,"Centro Hospitalar Trás-os-Montes e Alto Douro, EPE",327,0,327,2014,7,"-7.7515252,41.3031784",1
2014-08-01,Região de Saúde do Alentejo,"Hospital Espírito Santo de Évora, EPE",810,368,1178,2014,8,"-7.9032848,38.5684861",4
2014-08-01,Região de Saúde do Algarve,"Centro Hospitalar Universitário do Algarve,EPE",571,56,627,2014,8,"-7.9281554,37.0238973",5
2014-08-01,Região de Saúde do Centro,"Unidade Local de Saúde de Castelo Branco, EPE",111,74,185,2014,8,"-7.4981271,39.8212263",2
2014-09-01,Região de Saúde do Alentejo,"Unidade Local de Saúde do Baixo Alentejo, EPE",46,26,72,2014,9,"-7.8721227,38.014123",4
2014-09-01,Região de Saúde Norte,"Centro Hospitalar Universitário do Porto, EPE",279,0,279,2014,9,"-8.6172617,41.1472498",1
2014-10-01,Região de Saúde Norte,"Centro Hospitalar Universitário do Porto, EPE",306,0,306,2014,10,"-8.6172617,41.1472498",1
2014-10-01,Região de Saúde Norte,"Centro Hospitalar Trás-os-Montes e Alto Douro, EPE",446,0,446,2014,10,"-7.7515252,41.3031784",1
2014-11-01,Região de Saúde do Alentejo,"Unidade Local de Saúde do Norte Alentejano, EPE",699,980,1679,2014,11,"-7.4263845,39.3003425",4
2014-11-01,Região de Saúde do Centro,"Centro Hospitalar Universitário Cova da Beira, EPE",258,140,398,2014,11,"-7.4922407,40.2804158",2
2014-11-01,Região de Saúde do Centro,"Unidade Local de Saúde da Guarda, EPE",173,39,212,2014,11,"-7.2734793,40.5309916",2
2014-11-01,Região de Saúde Norte,"Centro Hospitalar Trás-os-Montes e Alto Douro, EPE",494,0,494,2014,11,"-7.7515252,41.3031784",1
2014-12-01,Região de Saúde do Alentejo,"Unidade Local de Saúde do Norte Alentejano, EPE",754,1049,1803,2014,12,"-7.4263845,39.3003425",4
2014-12-01,Região de Saúde do Algarve,"Centro Hospitalar Universitário do Algarve,EPE",971,100,1071,2014,12,"-7.9281554,37.0238973",5
2014-12-01,Região de Saúde do Centro,"Centro Hospitalar e Universitário de Coimbra, EPE",2070,1529,3599,2014,12,"-8.4098211,40.2191523",2
2014-12-01,Região de Saúde do Centro,"Unidade Local de Saúde de Castelo Branco, EPE",136,120,256,2014,12,"-7.4981271,39.8212263",2
2014-12-01,Região de Saúde LVT,"Hospital Professor Doutor Fernando Fonseca, EPE",0,0,0,2014,12,"-9.2264834,38.7422257",3
2014-12-01,Região de Saúde Norte,"Centro Hospitalar Universitário do Porto, EPE",345,0,345,2014,12,"-8.6172617,41.1472498",1
2015-01-01,Região de Saúde do Centro,"Centro Hospitalar do Baixo Vouga, EPE",21,82,103,2015,1,"-8.6543716,40.6362453",2
2015-01-01,Região de Saúde do Centro,"Centro Hospitalar Tondela-Viseu, EPE",29,31,60,2015,1,"-8.0827433,40.516364",2
2015-02-01,Região de Saúde do Alentejo,"Unidade Local de Saúde do Norte Alentejano, EPE",169,138,307,2015,2,"-7.4263845,39.3003425",4
2015-02-01,Região de Saúde do Centro,"Centro Hospitalar do Baixo Vouga, EPE",79,125,204,2015,2,"-8.6543716,40.6362453",2
2015-02-01,Região de Saúde do Centro,"Centro Hospitalar e Universitário de Coimbra, EPE",333,295,628,2015,2,"-8.4098211,40.2191523",2
2015-02-01,Região de Saúde do Centro,"Unidade Local de Saúde de Castelo Branco, EPE",28,17,45,2015,2,"-7.4981271,39.8212263",2
2015-02-01,Região de Saúde LVT,"Centro Hospitalar de Setúbal, EPE",0,0,0,2015,2,"-8.8818638,38.5283754",3
2015-02-01,Região de Saúde Norte,"Centro Hospitalar Universitário do Porto, EPE",71,0,71,2015,2,"-8.6172617,41.1472498",1
2015-03-01,Região de Saúde do Alentejo,"Hospital Espírito Santo de Évora, EPE",335,157,492,2015,3,"-7.9032848,38.5684861",4
2015-03-01,Região de Saúde do Centro,"Centro Hospitalar Universitário Cova da Beira, EPE",75,19,94,2015,3,"-7.4922407,40.2804158",2
2015-03-01,Região de Saúde do Centro,"Unidade Local de Saúde da Guarda, EPE",5,0,5,2015,3,"-7.2734793,40.5309916",2
2015-04-01,Região de Saúde do Alentejo,"Hospital Espírito Santo de Évora, EPE",438,214,652,2015,4,"-7.9032848,38.5684861",4
2015-04-01,Região de Saúde Norte,"Centro Hospitalar Universitário do Porto, EPE",133,0,133,2015,4,"-8.6172617,41.1472498",1
2015-04-01,Região de Saúde Norte,"Unidade Local de Saúde de Matosinhos, EPE",485,0,485,2015,4,"-8.6745115,41.1794456",1
2015-05-01,Região de Saúde do Alentejo,"Hospital Espírito Santo de Évora, EPE",547,268,815,2015,5,"-7.9032848,38.5684861",4
2015-05-01,Região de Saúde do Centro,"Centro Hospitalar do Baixo Vouga, EPE",223,273,496,2015,5,"-8.6543716,40.6362453",2
2015-05-01,Região de Saúde LVT,"Centro Hospitalar de Setúbal, EPE",0,0,0,2015,5,"-8.8818638,38.5283754",3
2015-05-01,Região de Saúde Norte,"Centro Hospitalar Trás-os-Montes e Alto Douro, EPE",148,0,148,2015,5,"-7.7515252,41.3031784",1
2015-05-01,Região de Saúde Norte,"Unidade Local de Saúde de Matosinhos, EPE",670,0,670,2015,5,"-8.6745115,41.1794456",1
2015-06-01,Região de Saúde do Alentejo,"Unidade Local de Saúde do Norte Alentejano, EPE",485,454,939,2015,6,"-7.4263845,39.3003425",4
2015-06-01,Região de Saúde do Algarve,"Centro Hospitalar Universitário do Algarve,EPE",628,63,691,2015,6,"-7.9281554,37.0238973",5
2015-06-01,Região de Saúde do Centro,"Centro Hospitalar Universitário Cova da Beira, EPE",148,52,200,2015,6,"-7.4922407,40.2804158",2
2015-06-01,Região de Saúde do Centro,"Unidade Local de Saúde da Guarda, EPE",25,0,25,2015,6,"-7.2734793,40.5309916",2
2015-07-01,Região de Saúde do Algarve,"Centro Hospitalar Universitário do Algarve,EPE",775,74,849,2015,7,"-7.9281554,37.0238973",5
2015-07-01,Região de Saúde LVT,"Centro Hospitalar de Setúbal, EPE",0,0,0,2015,7,"-8.8818638,38.5283754",3
2015-08-01,Região de Saúde do Centro,"Centro Hospitalar e Universitário de Coimbra, EPE",1478,1071,2549,2015,8,"-8.4098211,40.2191523",2
2015-08-01,Região de Saúde Norte,"Unidade Local de Saúde de Matosinhos, EPE",1276,0,1276,2015,8,"-8.6745115,41.1794456",1
2015-09-01,Região de Saúde Norte,"Centro Hospitalar Universitário do Porto, EPE",304,0,304,2015,9,"-8.6172617,41.1472498",1
2015-09-01,Região de Saúde Norte,"Centro Hospitalar Trás-os-Montes e Alto Douro, EPE",296,0,296,2015,9,"-7.7515252,41.3031784",1
2015-10-01,Região de Saúde do Alentejo,"Hospital Espírito Santo de Évora, EPE",985,440,1425,2015,10,"-7.9032848,38.5684861",4
2015-10-01,Região de Saúde do Alentejo,"Unidade Local de Saúde do Baixo Alentejo, EPE",66,38,104,2015,10,"-7.8721227,38.014123",4
2015-10-01,Região de Saúde Norte,"Centro Hospitalar Universitário do Porto, EPE",330,0,330,2015,10,"-8.6172617,41.1472498",1
2015-11-01,Região de Saúde do Centro,"Centro Hospitalar e Universitário de Coimbra, EPE",2145,1464,3609,2015,11,"-8.4098211,40.2191523",2
2015-12-01,Região de Saúde do Centro,"Centro Hospitalar e Universitário de Coimbra, EPE",2253,1530,3783,2015,12,"-8.4098211,40.2191523",2
2015-12-01,Região de Saúde do Centro,"Centro Hospitalar Tondela-Viseu, EPE",336,257,593,2015,12,"-8.0827433,40.516364",2
2015-12-01,Região de Saúde Norte,"Unidade Local de Saúde de Matosinhos, EPE",2080,0,2080,2015,12,"-8.6745115,41.1794456",1
2016-01-01,Região de Saúde do Centro,"Centro Hospitalar Universitário Cova da Beira, EPE",24,13,37,2016,1,"-7.4922407,40.2804158",2
2016-01-01,Região de Saúde Norte,"Centro Hospitalar Trás-os-Montes e Alto Douro, EPE",38,0,38,2016,1,"-7.7515252,41.3031784",1
2016-02-01,Região de Saúde do Alentejo,"Unidade Local de Saúde do Baixo Alentejo, EPE",13,5,18,2016,2,"-7.8721227,38.014123",4
2016-02-01,Região de Saúde do Alentejo,"Unidade Local de Saúde do Norte Alentejano, EPE",130,130,260,2016,2,"-7.4263845,39.3003425",4
2016-02-01,Região de Saúde do Centro,"Centro Hospitalar Tondela-Viseu, EPE",44,53,97,2016,2,"-8.0827433,40.516364",2
2016-02-01,Região de Saúde Norte,"Centro Hospitalar Universitário do Porto, EPE",85,0,85,2016,2,"-8.6172617,41.1472498",1
2016-03-01,Região de Saúde do Algarve,"Centro Hospitalar Universitário do Algarve,EPE",426,31,457,2016,3,"-7.9281554,37.0238973",5
2016-03-01,Região de Saúde do Centro,"Centro Hospitalar do Baixo Vouga, EPE",139,164,303,2016,3,"-8.6543716,40.6362453",2
2016-04-01,Região de Saúde do Algarve,"Centro Hospitalar Universitário do Algarve,EPE",571,49,620,2016,4,"-7.9281554,37.0238973",5
2016-04-01,Região de Saúde LVT,"Centro Hospitalar de Setúbal, EPE",0,0,0,2016,4,"-8.8818638,38.5283754",3
2016-04-01,Região de Saúde LVT,"Instituto Português Oncologia de Lisboa, EPE",1,0,1,2016,4,"-9.1634516,38.7396768",3
2016-05-01,Região de Saúde do Alentejo,"Unidade Local de Saúde do Baixo Alentejo, EPE",14,9,23,2016,5,"-7.8721227,38.014123",4
2016-05-01,Região de Saúde do Centro,"Centro Hospitalar Tondela-Viseu, EPE",118,89,207,2016,5,"-8.0827433,40.516364",2
2016-06-01,Região de Saúde do Alentejo,"Unidade Local de Saúde do Norte Alentejano, EPE",264,321,585,2016,6,"-7.4263845,39.3003425",4
2016-06-01,Região de Saúde do Centro,"Centro Hospitalar Tondela-Viseu, EPE",141,104,245,2016,6,"-8.0827433,40.516364",2
2016-06-01,Região de Saúde LVT,"Centro Hospitalar de Setúbal, EPE",0,0,0,2016,6,"-8.8818638,38.5283754",3
2016-06-01,Região de Saúde Norte,"Unidade Local de Saúde de Matosinhos, EPE",948,0,948,2016,6,"-8.6745115,41.1794456",1
2016-07-01,Região de Saúde do Centro,"Centro Hospitalar do Baixo Vouga, EPE",350,319,669,2016,7,"-8.6543716,40.6362453",2
2016-07-01,Região de Saúde do Centro,"Centro Hospitalar e Universitário de Coimbra, EPE",1587,796,2383,2016,7,"-8.4098211,40.2191523",2
2016-07-01,Região de Saúde do Centro,"Unidade Local de Saúde de Castelo Branco, EPE",106,72,178,2016,7,"-7.4981271,39.8212263",2
2016-07-01,Região de Saúde Norte,"Centro Hospitalar do Médio Ave, EPE",0,0,0,2016,7,"-8.4802503,41.3423984",1
2016-07-01,Região de Saúde Norte,"Unidade Local de Saúde de Matosinhos, EPE",1112,0,1112,2016,7,"-8.6745115,41.1794456",1
2016-08-01,Região de Saúde do Alentejo,"Unidade Local de Saúde do Norte Alentejano, EPE",324,391,715,2016,8,"-7.4263845,39.3003425",4
2016-08-01,Região de Saúde do Centro,"Centro Hospitalar Tondela-Viseu, EPE",165,126,291,2016,8,"-8.0827433,40.516364",2
2016-08-01,Região de Saúde do Centro,"Unidade Local de Saúde da Guarda, EPE",280,0,280,2016,8,"-7.2734793,40.5309916",2
2016-08-01,Região de Saúde do Centro,"Unidade Local de Saúde de Castelo Branco, EPE",107,72,179,2016,8,"-7.4981271,39.8212263",2
2016-08-01,Região de Saúde LVT,"Hospital Garcia de Orta, EPE",28,0,28,2016,8,"-9.1822554,38.6658713",3
2016-08-01,Região de Saúde Norte,"Centro Hospitalar do Médio Ave, EPE",0,0,0,2016,8,"-8.4802503,41.3423984",1
2016-08-01,Região de Saúde Norte,"Centro Hospitalar Trás-os-Montes e Alto Douro, EPE",377,0,377,2016,8,"-7.7515252,41.3031784",1
2016-09-01,Região de Saúde do Algarve,"Centro Hospitalar Universitário do Algarve,EPE",1260,96,1356,2016,9,"-7.9281554,37.0238973",5
2016-09-01,Região de Saúde do Centro,Centro Medicina de Reabilitação da Região Centro Rovisco Pais,20,1,21,2016,9,"-8.7707806,40.297919",2
2016-09-01,Região de Saúde Norte,"Centro Hospitalar Trás-os-Montes e Alto Douro, EPE",437,11,448,2016,9,"-7.7515252,41.3031784",1
2016-10-01,Região de Saúde do Alentejo,"Unidade Local de Saúde do Baixo Alentejo, EPE",21,17,38,2016,10,"-7.8721227,38.014123",4
2016-10-01,Região de Saúde do Centro,"Centro Hospitalar Universitário Cova da Beira, EPE",136,127,263,2016,10,"-7.4922407,40.2804158",2
2016-10-01,Região de Saúde do Centro,"Centro Hospitalar do Baixo Vouga, EPE",484,424,908,2016,10,"-8.6543716,40.6362453",2
2016-10-01,Região de Saúde LVT,"Centro Hospitalar de Setúbal, EPE",61,0,61,2016,10,"-8.8818638,38.5283754",3
2016-10-01,Região de Saúde Norte,"Centro Hospitalar Universitário do Porto, EPE",743,0,743,2016,10,"-8.6172617,41.1472498",1
2016-11-01,Região de Saúde do Algarve,"Centro Hospitalar Universitário do Algarve,EPE",1514,117,1631,2016,11,"-7.9281554,37.0238973",5
2016-11-01,Região de Saúde do Centro,"Centro Hospitalar do Baixo Vouga, EPE",525,465,990,2016,11,"-8.6543716,40.6362453",2
2016-12-01,Região de Saúde do Alentejo,"Unidade Local de Saúde do Baixo Alentejo, EPE",21,17,38,2016,12,"-7.8721227,38.014123",4
2016-12-01,Região de Saúde do Centro,"Centro Hospitalar do Baixo Vouga, EPE",540,490,1030,2016,12,"-8.6543716,40.6362453",2
2016-12-01,Região de Saúde do Centro,"Centro Hospitalar e Universitário de Coimbra, EPE",2619,1306,3925,2016,12,"-8.4098211,40.2191523",2
2016-12-01,Região de Saúde do Centro,Centro Medicina de Reabilitação da Região Centro Rovisco Pais,26,1,27,2016,12,"-8.7707806,40.297919",2
2016-12-01,Região de Saúde LVT,"Hospital Garcia de Orta, EPE",128,0,128,2016,12,"-9.1822554,38.6658713",3
2016-12-01,Região de Saúde Norte,"Centro Hospitalar Trás-os-Montes e Alto Douro, EPE",549,11,560,2016,12,"-7.7515252,41.3031784",1
2017-01-01,Região de Saúde do Alentejo,"Hospital Espírito Santo de Évora, EPE",77,39,116,2017,1,"-7.9032848,38.5684861",4
2017-02-01,Região de Saúde do Alentejo,"Hospital Espírito Santo de Évora, EPE",135,65,200,2017,2,"-7.9032848,38.5684861",4
2017-02-01,Região de Saúde do Centro,"Unidade Local de Saúde de Castelo Branco, EPE",46,5,51,2017,2,"-7.4981271,39.8212263",2
2017-02-01,Região de Saúde LVT,"Hospital Garcia de Orta, EPE",28,0,28,2017,2,"-9.1822554,38.6658713",3
2017-03-01,Região de Saúde do Alentejo,"Hospital Espírito Santo de Évora, EPE",209,94,303,2017,3,"-7.9032848,38.5684861",4
2017-03-01,Região de Saúde do Centro,"Centro Hospitalar Universitário Cova da Beira, EPE",49,33,82,2017,3,"-7.4922407,40.2804158",2
2017-03-01,Região de Saúde do Centro,"Centro Hospitalar Tondela-Viseu, EPE",45,29,74,2017,3,"-8.0827433,40.516364",2
2017-03-01,Região de Saúde LVT,"Centro Hospitalar Universitário Lisboa Central, EPE",3,0,3,2017,3,"-9.1371248,38.7166948",3
2017-03-01,Região de Saúde Norte,"Centro Hospitalar Universitário do Porto, EPE",347,0,347,2017,3,"-8.6172617,41.1472498",1
2017-03-01,Região de Saúde Norte,"Centro Hospitalar Trás-os-Montes e Alto Douro, EPE",123,0,123,2017,3,"-7.7515252,41.3031784",1
2017-04-01,Região de Saúde do Alentejo,"Unidade Local de Saúde do Baixo Alentejo, EPE",0,0,0,2017,4,"-7.8721227,38.014123",4
2017-04-01,Região de Saúde do Centro,Centro Medicina de Reabilitação da Região Centro Rovisco Pais,17,1,18,2017,4,"-8.7707806,40.297919",2
2017-04-01,Região de Saúde LVT,"Hospital Garcia de Orta, EPE",58,0,58,2017,4,"-9.1822554,38.6658713",3
2017-05-01,Região de Saúde do Alentejo,"Hospital Espírito Santo de Évora, EPE",362,129,491,2017,5,"-7.9032848,38.5684861",4
2017-05-01,Região de Saúde do Centro,"Centro Hospitalar e Universitário de Coimbra, EPE",990,521,1511,2017,5,"-8.4098211,40.2191523",2
2017-05-01,Região de Saúde do Centro,Centro Medicina de Reabilitação da Região Centro Rovisco Pais,17,1,18,2017,5,"-8.7707806,40.297919",2
2017-05-01,Região de Saúde do Centro,"Unidade Local de Saúde da Guarda, EPE",149,0,149,2017,5,"-7.2734793,40.5309916",2
2017-06-01,Região de Saúde do Alentejo,"Unidade Local de Saúde do Baixo Alentejo, EPE",0,0,0,2017,6,"-7.8721227,38.014123",4
2017-06-01,Região de Saúde do Centro,"Centro Hospitalar Universitário Cova da Beira, EPE",105,55,160,2017,6,"-7.4922407,40.2804158",2
2017-06-01,Região de Saúde do Centro,"Centro Hospitalar Tondela-Viseu, EPE",86,63,149,2017,6,"-8.0827433,40.516364",2
2017-06-01,Região de Saúde Norte,"Centro Hospitalar Universitário do Porto, EPE",747,0,747,2017,6,"-8.6172617,41.1472498",1
2017-07-01,Região de Saúde do Alentejo,"Hospital Espírito Santo de Évora, EPE",502,179,681,2017,7,"-7.9032848,38.5684861",4
2017-07-01,Região de Saúde do Alentejo,"Unidade Local de Saúde do Litoral Alentejano, EPE",10,8,18,2017,7,"-8.6956768,38.0162314",4
2017-07-01,Região de Saúde LVT,"Centro Hospitalar Universitário Lisboa Central, EPE",10,9,19,2017,7,"-9.1371248,38.7166948",3
2017-07-01,Região de Saúde Norte,"Unidade Local de Saúde de Matosinhos, EPE",1562,7828,9390,2017,7,"-8.6745115,41.1794456",1
2017-09-01,Região de Saúde do Alentejo,"Unidade Local de Saúde do Norte Alentejano, EPE",510,467,977,2017,9,"-7.4263845,39.3003425",4
2017-09-01,Região de Saúde do Centro,"Unidade Local de Saúde da Guarda, EPE",345,0,345,2017,9,"-7.2734793,40.5309916",2
2017-10-01,Região de Saúde do Alentejo,"Hospital Espírito Santo de Évora, EPE",698,253,951,2017,10,"-7.9032848,38.5684861",4
2017-10-01,Região de Saúde do Centro,"Centro Hospitalar e Universitário de Coimbra, EPE",1896,867,2763,2017,10,"-8.4098211,40.2191523",2
2017-10-01,Região de Saúde do Centro,"Unidade Local de Saúde da Guarda, EPE",421,0,421,2017,10,"-7.2734793,40.5309916",2
2017-10-01,Região de Saúde Norte,"Unidade Local de Saúde do Nordeste, EPE",3,0,3,2017,10,"-6.7888197,41.8056532",1
2017-11-01,Região de Saúde do Alentejo,"Unidade Local de Saúde do Litoral Alentejano, EPE",21,20,41,2017,11,"-8.6956768,38.0162314",4
2017-11-01,Região de Saúde do Centro,"Unidade Local de Saúde da Guarda, EPE",479,0,479,2017,11,"-7.2734793,40.5309916",2
2017-11-01,Região de Saúde Norte,"Unidade Local de Saúde de Matosinhos, EPE",2375,12239,14614,2017,11,"-8.6745115,41.1794456",1
2017-12-01,Região de Saúde do Alentejo,"Hospital Espírito Santo de Évora, EPE",834,305,1139,2017,12,"-7.9032848,38.5684861",4
2017-12-01,Região de Saúde do Alentejo,"Unidade Local de Saúde do Norte Alentejano, EPE",652,636,1288,2017,12,"-7.4263845,39.3003425",4
2017-12-01,Região de Saúde do Centro,"Centro Hospitalar do Baixo Vouga, EPE",539,511,1050,2017,12,"-8.6543716,40.6362453",2
2017-12-01,Região de Saúde Norte,"Centro Hospitalar Trás-os-Montes e Alto Douro, EPE",527,1,528,2017,12,"-7.7515252,41.3031784",1
2017-12-01,Região de Saúde Norte,"Unidade Local de Saúde do Nordeste, EPE",3,0,3,2017,12,"-6.7888197,41.8056532",1
2018-01-01,Região de Saúde do Centro,"Unidade Local de Saúde da Guarda, EPE",0,0,0,2018,1,"-7.2734793,40.5309916",2
2018-01-01,Região de Saúde LVT,"Centro Hospitalar Médio Tejo, EPE",0,5,5,2018,1,"-8.5404429,39.478072",3
2018-01-01,Região de Saúde Norte,"Unidade Local de Saúde de Matosinhos, EPE",0,1194,1194,2018,1,"-8.6745115,41.1794456",1
2018-02-01,Região de Saúde do Alentejo,"Unidade Local de Saúde do Litoral Alentejano, EPE",1,5,6,2018,2,"-8.6956768,38.0162314",4
2018-02-01,Região de Saúde do Alentejo,"Unidade Local de Saúde do Norte Alentejano, EPE",98,124,222,2018,2,"-7.4263845,39.3003425",4
2018-02-01,Região de Saúde do Centro,"Centro Hospitalar Universitário Cova da Beira, EPE",67,22,89,2018,2,"-7.4922407,40.2804158",2
2018-02-01,Região de Saúde do Centro,"Centro Hospitalar do Baixo Vouga, EPE",25,43,68,2018,2,"-8.6543716,40.6362453",2
2018-02-01,Região de Saúde do Centro,"Unidade Local de Saúde de Castelo Branco, EPE",64,23,87,2018,2,"-7.4981271,39.8212263",2
2018-02-01,Região de Saúde LVT,"Centro Hospitalar Universitário de Lisboa Norte, EPE",66,0,66,2018,2,"-9.1616116,38.7500861",3
2018-02-01,Região de Saúde Norte,"Centro Hospitalar Universitário do Porto, EPE",325,0,325,2018,2,"-8.6172617,41.1472498",1
2018-02-01,Região de Saúde Norte,"Centro Hospitalar Trás-os-Montes e Alto Douro, EPE",82,0,82,2018,2,"-7.7515252,41.3031784",1
2018-02-01,Região de Saúde Norte,"Unidade Local de Saúde de Matosinhos, EPE",0,2109,2109,2018,2,"-8.6745115,41.1794456",1
2018-03-01,Região de Saúde do Centro,"Centro Hospitalar Universitário Cova da Beira, EPE",129,41,170,2018,3,"-7.4922407,40.2804158",2
2018-03-01,Região de Saúde Norte,"Instituto Português Oncologia do Porto, EPE",28,17,45,2018,3,"-8.6062881,41.1785642",1
2018-03-01,Região de Saúde Norte,"Unidade Local de Saúde de Matosinhos, EPE",0,3257,3257,2018,3,"-8.6745115,41.1794456",1
2018-04-01,Região de Saúde do Alentejo,"Unidade Local de Saúde do Baixo Alentejo, EPE",7,3,10,2018,4,"-7.8721227,38.014123",4
2018-04-01,Região de Saúde do Alentejo,"Unidade Local de Saúde do Norte Alentejano, EPE",167,230,397,2018,4,"-7.4263845,39.3003425",4
2018-04-01,Região de Saúde do Algarve,"Centro Hospitalar Universitário do Algarve,EPE",8,3,11,2018,4,"-7.9281554,37.0238973",5
2018-04-01,Região de Saúde do Centro,"Centro Hospitalar do Baixo Vouga, EPE",89,104,193,2018,4,"-8.6543716,40.6362453",2
2018-04-01,Região de Saúde LVT,"Centro Hospitalar Universitário Lisboa Central, EPE",7,18,25,2018,4,"-9.1371248,38.7166948",3
2018-04-01,Região de Saúde LVT,"Centro Hospitalar de Lisboa Ocidental, EPE",35,0,35,2018,4,"-9.216985,38.708454",3
2018-04-01,Região de Saúde Norte,"Unidade Local de Saúde de Matosinhos, EPE",0,4307,4307,2018,4,"-8.6745115,41.1794456",1
2018-05-01,Região de Saúde do Centro,Hospital Arcebispo João Crisóstomo,5,0,5,2018,5,"-8.5933462,40.3470015",2
2018-05-01,Região de Saúde Norte,"Centro Hospitalar Universitário do Porto, EPE",1003,0,1003,2018,5,"-8.6172617,41.1472498",1
2018-05-01,Região de Saúde Norte,"Instituto Português Oncologia do Porto, EPE",50,34,84,2018,5,"-8.6062881,41.1785642",1
2018-06-01,Região de Saúde do Centro,"Centro Hospitalar Tondela-Viseu, EPE",62,44,106,2018,6,"-8.0827433,40.516364",2
2018-06-01,Região de Saúde do Centro,Centro Medicina de Reabilitação da Região Centro Rovisco Pais,14,2,16,2018,6,"-8.7707806,40.297919",2
2018-06-01,Região de Saúde do Centro,Hospital Arcebispo João Crisóstomo,10,0,10,2018,6,"-8.5933462,40.3470015",2
2018-06-01,Região de Saúde LVT,"Centro Hospitalar Universitário de Lisboa Norte, EPE",220,0,220,2018,6,"-9.1616116,38.7500861",3
2018-06-01,Região de Saúde Norte,"Centro Hospitalar Trás-os-Montes e Alto Douro, EPE",149,0,149,2018,6,"-7.7515252,41.3031784",1
2018-06-01,Região de Saúde Norte,"Instituto Português Oncologia do Porto, EPE",63,47,110,2018,6,"-8.6062881,41.1785642",1
2018-07-01,Região de Saúde do Centro,"Centro Hospitalar do Baixo Vouga, EPE",234,234,468,2018,7,"-8.6543716,40.6362453",2
2018-07-01,Região de Saúde do Centro,Centro Medicina de Reabilitação da Região Centro Rovisco Pais,21,2,23,2018,7,"-8.7707806,40.297919",2
2018-07-01,Região de Saúde Norte,"Centro Hospitalar Universitário do Porto, EPE",1521,0,1521,2018,7,"-8.6172617,41.1472498",1
2018-08-01,Região de Saúde do Alentejo,"Unidade Local de Saúde do Norte Alentejano, EPE",424,352,776,2018,8,"-7.4263845,39.3003425",4
2018-08-01,Região de Saúde do Algarve,"Centro Hospitalar Universitário do Algarve,EPE",11,6,17,2018,8,"-7.9281554,37.0238973",5
2018-08-01,Região de Saúde do Centro,"Unidade Local de Saúde de Castelo Branco, EPE",155,100,255,2018,8,"-7.4981271,39.8212263",2
2018-08-01,Região de Saúde LVT,"Centro Hospitalar Universitário Lisboa Central, EPE",29,25,54,2018,8,"-9.1371248,38.7166948",3
2018-08-01,Região de Saúde LVT,"Centro Hospitalar de Lisboa Ocidental, EPE",80,0,80,2018,8,"-9.216985,38.708454",3
2018-08-01,Região de Saúde Norte,"Centro Hospitalar Universitário do Porto, EPE",1733,0,1733,2018,8,"-8.6172617,41.1472498",1
2018-08-01,Região de Saúde Norte,"Unidade Local de Saúde do Nordeste, EPE",0,1,1,2018,8,"-6.7888197,41.8056532",1
2018-09-01,Região de Saúde do Centro,"Centro Hospitalar de Leiria, EPE",265,195,460,2018,9,"-8.7982706,39.7414812",2
2018-09-01,Região de Saúde do Centro,"Unidade Local de Saúde de Castelo Branco, EPE",161,113,274,2018,9,"-7.4981271,39.8212263",2
2018-09-01,Região de Saúde LVT,"Centro Hospitalar Universitário de Lisboa Norte, EPE",347,0,347,2018,9,"-9.1616116,38.7500861",3
2018-09-01,Região de Saúde Norte,"Unidade Local de Saúde do Nordeste, EPE",0,1,1,2018,9,"-6.7888197,41.8056532",1
2018-10-01,Região de Saúde do Alentejo,"Unidade Local de Saúde do Baixo Alentejo, EPE",41,17,58,2018,10,"-7.8721227,38.014123",4
2018-10-01,Região de Saúde do Alentejo,"Unidade Local de Saúde do Litoral Alentejano, EPE",23,34,57,2018,10,"-8.6956768,38.0162314",4
2018-10-01,Região de Saúde do Algarve,"Centro Hospitalar Universitário do Algarve,EPE",16,7,23,2018,10,"-7.9281554,37.0238973",5
2018-10-01,Região de Saúde LVT,"Hospital Garcia de Orta, EPE",483,0,483,2018,10,"-9.1822554,38.6658713",3
2018-10-01,Região de Saúde Norte,"Centro Hospitalar Entre Douro e Vouga, EPE",4,0,4,2018,10,"-8.5458794,40.9293884",1
2018-10-01,Região de Saúde Norte,"Unidade Local de Saúde de Matosinhos, EPE",0,10629,10629,2018,10,"-8.6745115,41.1794456",1
2018-11-01,Região de Saúde do Alentejo,"Hospital Espírito Santo de Évora, EPE",781,289,1070,2018,11,"-7.9032848,38.5684861",4
2018-11-01,Região de Saúde do Centro,"Centro Hospitalar Universitário Cova da Beira, EPE",436,135,571,2018,11,"-7.4922407,40.2804158",2
2018-11-01,Região de Saúde do Centro,"Centro Hospitalar e Universitário de Coimbra, EPE",1787,832,2619,2018,11,"-8.4098211,40.2191523",2
2018-11-01,Região de Saúde do Centro,"Centro Hospitalar Tondela-Viseu, EPE",175,134,309,2018,11,"-8.0827433,40.516364",2
2018-11-01,Região de Saúde do Centro,Centro Medicina de Reabilitação da Região Centro Rovisco Pais,35,2,37,2018,11,"-8.7707806,40.297919",2
2018-11-01,Região de Saúde LVT,"Centro Hospitalar Universitário de Lisboa Norte, EPE",676,3,679,2018,11,"-9.1616116,38.7500861",3
2018-11-01,Região de Saúde Norte,"Centro Hospitalar Trás-os-Montes e Alto Douro, EPE",496,0,496,2018,11,"-7.7515252,41.3031784",1
2018-11-01,Região de Saúde Norte,"Unidade Local de Saúde do Nordeste, EPE",0,1,1,2018,11,"-6.7888197,41.8056532",1
2018-12-01,Região de Saúde do Alentejo,"Hospital Espírito Santo de Évora, EPE",999,388,1387,2018,12,"-7.9032848,38.5684861",4
2018-12-01,Região de Saúde do Alentejo,"Unidade Local de Saúde do Litoral Alentejano, EPE",28,33,61,2018,12,"-8.6956768,38.0162314",4
2018-12-01,Região de Saúde do Alentejo,"Unidade Local de Saúde do Norte Alentejano, EPE",745,483,1228,2018,12,"-7.4263845,39.3003425",4
2018-12-01,Região de Saúde LVT,"Centro Hospitalar Universitário Lisboa Central, EPE",47,42,89,2018,12,"-9.1371248,38.7166948",3
2018-12-01,Região de Saúde LVT,"Instituto Português Oncologia de Lisboa, EPE",0,0,0,2018,12,"-9.1634516,38.7396768",3
2019-01-01,Região de Saúde do Alentejo,"Unidade Local de Saúde do Baixo Alentejo, EPE",7,14,21,2019,1,"-7.8721227,38.014123",4
2019-01-01,Região de Saúde do Centro,"Centro Hospitalar e Universitário de Coimbra, EPE",229,67,296,2019,1,"-8.4098211,40.2191523",2
2019-01-01,Região de Saúde do Centro,"Centro Hospitalar Tondela-Viseu, EPE",26,7,33,2019,1,"-8.0827433,40.516364",2
2019-01-01,Região de Saúde do Centro,Centro Medicina de Reabilitação da Região Centro Rovisco Pais,4,0,4,2019,1,"-8.7707806,40.297919",2
2019-01-01,Região de Saúde LVT,"Centro Hospitalar Universitário Lisboa Central, EPE",2,0,2,2019,1,"-9.1371248,38.7166948",3
2019-01-01,Região de Saúde LVT,"Centro Hospitalar Universitário de Lisboa Norte, EPE",120,1,121,2019,1,"-9.1616116,38.7500861",3
2019-01-01,Região de Saúde Norte,"Centro Hospitalar Entre Douro e Vouga, EPE",0,0,0,2019,1,"-8.5458794,40.9293884",1
2019-02-01,Região de Saúde do Alentejo,"Unidade Local de Saúde do Litoral Alentejano, EPE",7,9,16,2019,2,"-8.6956768,38.0162314",4
2019-02-01,Região de Saúde do Algarve,"Centro Hospitalar Universitário do Algarve,EPE",0,0,0,2019,2,"-7.9281554,37.0238973",5
2019-02-01,Região de Saúde do Centro,"Unidade Local de Saúde de Castelo Branco, EPE",59,14,73,2019,2,"-7.4981271,39.8212263",2
2019-02-01,Região de Saúde LVT,"Centro Hospitalar Médio Tejo, EPE",1,0,1,2019,2,"-8.5404429,39.478072",3
2019-02-01,Região de Saúde Norte,"Centro Hospitalar Entre Douro e Vouga, EPE",0,0,0,2019,2,"-8.5458794,40.9293884",1
2019-02-01,Região de Saúde Norte,"Instituto Português Oncologia do Porto, EPE",9,7,16,2019,2,"-8.6062881,41.1785642",1
2019-02-01,Região de Saúde Norte,"Unidade Local de Saúde de Matosinhos, EPE",0,1995,1995,2019,2,"-8.6745115,41.1794456",1
2019-03-01,Região de Saúde do Alentejo,"Hospital Espírito Santo de Évora, EPE",310,85,395,2019,3,"-7.9032848,38.5684861",4
2019-03-01,Região de Saúde do Centro,"Centro Hospitalar Universitário Cova da Beira, EPE",152,25,177,2019,3,"-7.4922407,40.2804158",2
2019-03-01,Região de Saúde do Centro,"Centro Hospitalar e Universitário de Coimbra, EPE",657,172,829,2019,3,"-8.4098211,40.2191523",2
2019-03-01,Região de Saúde Norte,"Centro Hospitalar Trás-os-Montes e Alto Douro, EPE",338,0,338,2019,3,"-7.7515252,41.3031784",1
2019-04-01,Região de Saúde do Centro,"Centro Hospitalar Universitário Cova da Beira, EPE",197,29,226,2019,4,"-7.4922407,40.2804158",2
2019-04-01,Região de Saúde do Centro,"Centro Hospitalar de Leiria, EPE",118,87,205,2019,4,"-8.7982706,39.7414812",2
2019-04-01,Região de Saúde do Centro,Centro Medicina de Reabilitação da Região Centro Rovisco Pais,5,0,5,2019,4,"-8.7707806,40.297919",2
2019-04-01,Região de Saúde do Centro,"Unidade Local de Saúde de Castelo Branco, EPE",118,39,157,2019,4,"-7.4981271,39.8212263",2
2019-05-01,Região de Saúde do Centro,"Centro Hospitalar de Leiria, EPE",160,113,273,2019,5,"-8.7982706,39.7414812",2
2019-05-01,Região de Saúde do Centro,Centro Medicina de Reabilitação da Região Centro Rovisco Pais,5,0,5,2019,5,"-8.7707806,40.297919",2
2019-05-01,Região de Saúde LVT,"Centro Hospitalar Médio Tejo, EPE",3,3,6,2019,5,"-8.5404429,39.478072",3
2019-05-01,Região de Saúde Norte,"Centro Hospitalar Universitário do Porto, EPE",1076,0,1076,2019,5,"-8.6172617,41.1472498",1
2019-05-01,Região de Saúde Norte,"Hospital Santa Maria Maior, EPE",0,4,4,2019,5,"-8.6171561,41.5324234",1
2019-05-01,Região de Saúde Norte,"Instituto Português Oncologia do Porto, EPE",25,21,46,2019,5,"-8.6062881,41.1785642",1
2019-05-01,Região de Saúde Norte,"Unidade Local de Saúde de Matosinhos, EPE",0,4981,4981,2019,5,"-8.6745115,41.1794456",1
2019-06-01,Região de Saúde do Alentejo,"Unidade Local de Saúde do Litoral Alentejano, EPE",13,18,31,2019,6,"-8.6956768,38.0162314",4
2019-06-01,Região de Saúde do Centro,Centro Medicina de Reabilitação da Região Centro Rovisco Pais,5,0,5,2019,6,"-8.7707806,40.297919",2
2019-07-01,Região de Saúde do Alentejo,"Unidade Local de Saúde do Norte Alentejano, EPE",342,129,471,2019,7,"-7.4263845,39.3003425",4
2019-07-01,Região de Saúde do Centro,"Centro Hospitalar de Leiria, EPE",198,161,359,2019,7,"-8.7982706,39.7414812",2
2019-07-01,Região de Saúde LVT,"Centro Hospitalar Médio Tejo, EPE",5,5,10,2019,7,"-8.5404429,39.478072",3
2019-07-01,Região de Saúde Norte,"Centro Hospitalar Trás-os-Montes e Alto Douro, EPE",716,0,716,2019,7,"-7.7515252,41.3031784",1
2019-08-01,Região de Saúde do Centro,"Centro Hospitalar Universitário Cova da Beira, EPE",313,56,369,2019,8,"-7.4922407,40.2804158",2
2019-08-01,Região de Saúde do Centro,"Centro Hospitalar de Leiria, EPE",231,182,413,2019,8,"-8.7982706,39.7414812",2
2019-08-01,Região de Saúde do Centro,"Centro Hospitalar e Universitário de Coimbra, EPE",1735,533,2268,2019,8,"-8.4098211,40.2191523",2
2019-08-01,Região de Saúde do Centro,Hospital Arcebispo João Crisóstomo,66,0,66,2019,8,"-8.5933462,40.3470015",2
2019-08-01,Região de Saúde do Centro,"Unidade Local de Saúde de Castelo Branco, EPE",184,92,276,2019,8,"-7.4981271,39.8212263",2
2019-08-01,Região de Saúde LVT,"Centro Hospitalar Universitário de Lisboa Norte, EPE",2125,29,2154,2019,8,"-9.1616116,38.7500861",3
2019-09-01,Região de Saúde do Alentejo,"Hospital Espírito Santo de Évora, EPE",983,475,1458,2019,9,"-7.9032848,38.5684861",4
2019-09-01,Região de Saúde do Centro,"Centro Hospitalar Universitário Cova da Beira, EPE",349,61,410,2019,9,"-7.4922407,40.2804158",2
2019-09-01,Região de Saúde do Centro,"Centro Hospitalar Tondela-Viseu, EPE",193,65,258,2019,9,"-8.0827433,40.516364",2
2019-09-01,Região de Saúde do Centro,Hospital Arcebispo João Crisóstomo,74,0,74,2019,9,"-8.5933462,40.3470015",2
2019-09-01,Região de Saúde LVT,"Centro Hospitalar Universitário Lisboa Central, EPE",24,22,46,2019,9,"-9.1371248,38.7166948",3
2019-09-01,Região de Saúde Norte,"Unidade Local de Saúde de Matosinhos, EPE",0,8789,8789,2019,9,"-8.6745115,41.1794456",1
2019-10-01,Região de Saúde do Alentejo,"Unidade Local de Saúde do Litoral Alentejano, EPE",13,18,31,2019,10,"-8.6956768,38.0162314",4
2019-10-01,Região de Saúde do Alentejo,"Unidade Local de Saúde do Norte Alentejano, EPE",475,198,673,2019,10,"-7.4263845,39.3003425",4
2019-10-01,Região de Saúde do Centro,"Centro Hospitalar de Leiria, EPE",258,231,489,2019,10,"-8.7982706,39.7414812",2
2019-10-01,Região de Saúde do Centro,Hospital Arcebispo João Crisóstomo,89,0,89,2019,10,"-8.5933462,40.3470015",2
2019-10-01,Região de Saúde LVT,"Hospital Garcia de Orta, EPE",0,0,0,2019,10,"-9.1822554,38.6658713",3
2019-10-01,Região de Saúde Norte,"Hospital de Braga, EPE",737,0,737,2019,10,"-8.398982,41.56785",1
2019-11-01,Região de Saúde do Alentejo,"Unidade Local de Saúde do Litoral Alentejano, EPE",13,18,31,2019,11,"-8.6956768,38.0162314",4
2019-11-01,Região de Saúde do Centro,"Centro Hospitalar do Baixo Vouga, EPE",630,429,1059,2019,11,"-8.6543716,40.6362453",2
2019-11-01,Região de Saúde LVT,"Centro Hospitalar de Setúbal, EPE",0,0,0,2019,11,"-8.8818638,38.5283754",3
2019-11-01,Região de Saúde LVT,"Centro Hospitalar Universitário de Lisboa Norte, EPE",3242,30,3272,2019,11,"-9.1616116,38.7500861",3
2019-11-01,Região de Saúde Norte,"Centro Hospitalar Trás-os-Montes e Alto Douro, EPE",981,0,981,2019,11,"-7.7515252,41.3031784",1
2019-11-01,Região de Saúde Norte,"Hospital de Braga, EPE",1039,0,1039,2019,11,"-8.398982,41.56785",1
2019-12-01,Região de Saúde do Algarve,"Centro Hospitalar Universitário do Algarve,EPE",0,0,0,2019,12,"-7.9281554,37.0238973",5
2019-12-01,Região de Saúde do Centro,"Unidade Local de Saúde de Castelo Branco, EPE",273,144,417,2019,12,"-7.4981271,39.8212263",2
2019-12-01,Região de Saúde Norte,"Centro Hospitalar Trás-os-Montes e Alto Douro, EPE",1038,0,1038,2019,12,"-7.7515252,41.3031784",1
2020-01-01,Região de Saúde do Centro,"Centro Hospitalar Universitário Cova da Beira, EPE",33,5,38,2020,1,"-7.4922407,40.2804158",2
2020-01-01,Região de Saúde do Centro,"Centro Hospitalar do Baixo Vouga, EPE",65,58,123,2020,1,"-8.6543716,40.6362453",2
2020-01-01,Região de Saúde LVT,"Hospital Garcia de Orta, EPE",0,0,0,2020,1,"-9.1822554,38.6658713",3
2020-01-01,Região de Saúde Norte,"Centro Hospitalar Universitário do Porto, EPE",222,0,222,2020,1,"-8.6172617,41.1472498",1
2020-01-01,Região de Saúde Norte,"Unidade Local de Saúde de Matosinhos, EPE",0,907,907,2020,1,"-8.6745115,41.1794456",1
2020-02-01,Região de Saúde do Centro,"Centro Hospitalar e Universitário de Coimbra, EPE",386,136,522,2020,2,"-8.4098211,40.2191523",2
2020-02-01,Região de Saúde Norte,"Instituto Português Oncologia do Porto, EPE",23,12,35,2020,2,"-8.6062881,41.1785642",1
2020-03-01,Região de Saúde do Algarve,"Centro Hospitalar Universitário do Algarve,EPE",0,0,0,2020,3,"-7.9281554,37.0238973",5
2020-03-01,Região de Saúde do Centro,"Centro Hospitalar do Baixo Vouga, EPE",138,113,251,2020,3,"-8.6543716,40.6362453",2
2020-03-01,Região de Saúde LVT,"Hospital Garcia de Orta, EPE",0,0,0,2020,3,"-9.1822554,38.6658713",3
2020-04-01,Região de Saúde do Alentejo,"Hospital Espírito Santo de Évora, EPE",343,153,496,2020,4,"-7.9032848,38.5684861",4
2020-04-01,Região de Saúde do Alentejo,"Unidade Local de Saúde do Litoral Alentejano, EPE",0,0,0,2020,4,"-8.6956768,38.0162314",4
2020-04-01,Região de Saúde LVT,"Centro Hospitalar Universitário Lisboa Central, EPE",0,7,7,2020,4,"-9.1371248,38.7166948",3
2020-04-01,Região de Saúde LVT,"Centro Hospitalar de Lisboa Ocidental, EPE",87,0,87,2020,4,"-9.216985,38.708454",3
2020-04-01,Região de Saúde LVT,"Centro Hospitalar Médio Tejo, EPE",2,8,10,2020,4,"-8.5404429,39.478072",3
2020-04-01,Região de Saúde Norte,"Unidade Local de Saúde de Matosinhos, EPE",0,3324,3324,2020,4,"-8.6745115,41.1794456",1
2020-05-01,Região de Saúde do Algarve,"Centro Hospitalar Universitário do Algarve,EPE",0,0,0,2020,5,"-7.9281554,37.0238973",5
2020-05-01,Região de Saúde do Centro,"Centro Hospitalar do Baixo Vouga, EPE",143,130,273,2020,5,"-8.6543716,40.6362453",2
2020-05-01,Região de Saúde do Centro,"Centro Hospitalar e Universitário de Coimbra, EPE",822,241,1063,2020,5,"-8.4098211,40.2191523",2
2020-05-01,Região de Saúde do Centro,"Unidade Local de Saúde de Castelo Branco, EPE",76,41,117,2020,5,"-7.4981271,39.8212263",2
2020-05-01,Região de Saúde LVT,"Centro Hospitalar Universitário Lisboa Central, EPE",80,413,493,2020,5,"-9.1371248,38.7166948",3
2020-05-01,Região de Saúde LVT,Centro Hospitalar Psiquiátrico de Lisboa,85,3753,3838,2020,5,"-9.1460705,38.7569771",3
2020-05-01,Região de Saúde Norte,"Instituto Português Oncologia do Porto, EPE",51,29,80,2020,5,"-8.6062881,41.1785642",1
2020-06-01,Região de Saúde do Alentejo,"Unidade Local de Saúde do Baixo Alentejo, EPE",476,2656,3132,2020,6,"-7.8721227,38.014123",4
2020-06-01,Região de Saúde do Alentejo,"Unidade Local de Saúde do Litoral Alentejano, EPE",0,0,0,2020,6,"-8.6956768,38.0162314",4
2020-06-01,Região de Saúde do Algarve,"Centro Hospitalar Universitário do Algarve,EPE",0,0,0,2020,6,"-7.9281554,37.0238973",5
2020-06-01,Região de Saúde do Centro,"Centro Hospitalar e Universitário de Coimbra, EPE",1050,297,1347,2020,6,"-8.4098211,40.2191523",2
2020-06-01,Região de Saúde LVT,"Centro Hospitalar Universitário Lisboa Central, EPE",91,547,638,2020,6,"-9.1371248,38.7166948",3
2020-06-01,Região de Saúde LVT,"Centro Hospitalar de Lisboa Ocidental, EPE",118,0,118,2020,6,"-9.216985,38.708454",3
2020-06-01,Região de Saúde LVT,"Hospital Garcia de Orta, EPE",0,0,0,2020,6,"-9.1822554,38.6658713",3
2020-07-01,Região de Saúde do Alentejo,"Unidade Local de Saúde do Baixo Alentejo, EPE",493,2883,3376,2020,7,"-7.8721227,38.014123",4
2020-07-01,Região de Saúde do Algarve,"Centro Hospitalar Universitário do Algarve,EPE",0,0,0,2020,7,"-7.9281554,37.0238973",5
2020-07-01,Região de Saúde LVT,"Centro Hospitalar de Lisboa Ocidental, EPE",128,0,128,2020,7,"-9.216985,38.708454",3
2020-07-01,Região de Saúde Norte,"Centro Hospitalar Universitário do Porto, EPE",1085,0,1085,2020,7,"-8.6172617,41.1472498",1
2020-07-01,Região de Saúde Norte,"Centro Hospitalar Trás-os-Montes e Alto Douro, EPE",449,2,451,2020,7,"-7.7515252,41.3031784",1
2020-07-01,Região de Saúde Norte,"Instituto Português Oncologia do Porto, EPE",63,43,106,2020,7,"-8.6062881,41.1785642",1
2020-08-01,Região de Saúde do Alentejo,"Unidade Local de Saúde do Norte Alentejano, EPE",167,133,300,2020,8,"-7.4263845,39.3003425",4
2020-08-01,Região de Saúde do Centro,"Centro Hospitalar Universitário Cova da Beira, EPE",168,45,213,2020,8,"-7.4922407,40.2804158",2
2020-08-01,Região de Saúde LVT,"Centro Hospitalar de Setúbal, EPE",0,0,0,2020,8,"-8.8818638,38.5283754",3
2020-08-01,Região de Saúde LVT,"Hospital Garcia de Orta, EPE",0,0,0,2020,8,"-9.1822554,38.6658713",3
2020-08-01,Região de Saúde Norte,"Hospital de Braga, EPE",3294,0,3294,2020,8,"-8.398982,41.56785",1
2020-08-01,Região de Saúde Norte,"Instituto Português Oncologia do Porto, EPE",70,48,118,2020,8,"-8.6062881,41.1785642",1
2020-08-01,Região de Saúde Norte,"Unidade Local de Saúde de Matosinhos, EPE",0,6240,6240,2020,8,"-8.6745115,41.1794456",1
2020-09-01,Região de Saúde do Alentejo,"Unidade Local de Saúde do Baixo Alentejo, EPE",607,3450,4057,2020,9,"-7.8721227,38.014123",4
2020-09-01,Região de Saúde do Centro,Hospital Arcebispo João Crisóstomo,99,0,99,2020,9,"-8.5933462,40.3470015",2
2020-09-01,Região de Saúde LVT,"Centro Hospitalar de Setúbal, EPE",0,0,0,2020,9,"-8.8818638,38.5283754",3
2020-09-01,Região de Saúde LVT,"Centro Hospitalar Médio Tejo, EPE",2,16,18,2020,9,"-8.5404429,39.478072",3
2020-09-01,Região de Saúde Norte,"Centro Hospitalar Trás-os-Montes e Alto Douro, EPE",530,2,532,2020,9,"-7.7515252,41.3031784",1
2020-09-01,Região de Saúde Norte,"Centro Hospitalar Vila Nova de Gaia/Espinho, EPE",795,0,795,2020,9,"-8.5972617,41.1094138",1
2020-10-01,Região de Saúde do Alentejo,"Unidade Local de Saúde do Litoral Alentejano, EPE",0,0,0,2020,10,"-8.6956768,38.0162314",4
2020-10-01,Região de Saúde LVT,Centro Hospitalar Psiquiátrico de Lisboa,234,7808,8042,2020,10,"-9.1460705,38.7569771",3
2020-12-01,Região de Saúde do Centro,"Unidade Local de Saúde de Castelo Branco, EPE",135,101,236,2020,12,"-7.4981271,39.8212263",2
2020-12-01,Região de Saúde LVT,Centro Hospitalar Psiquiátrico de Lisboa,311,9386,9697,2020,12,"-9.1460705,38.7569771",3
2020-12-01,Região de Saúde Norte,"Centro Hospitalar Universitário de São João, EPE",0,0,0,2020,12,"-8.6010558,41.1831056",1
2020-12-01,Região de Saúde Norte,"Unidade Local de Saúde de Matosinhos, EPE",0,9192,9192,2020,12,"-8.6745115,41.1794456",1
2021-01-01,Região de Saúde do Centro,"Centro Hospitalar Universitário Cova da Beira, EPE",1114,3124,4238,2021,1,"-7.4922407,40.2804158",2
2021-01-01,Região de Saúde LVT,"Centro Hospitalar de Lisboa Ocidental, EPE",6,0,6,2021,1,"-9.216985,38.708454",3
2021-01-01,Região de Saúde LVT,"Centro Hospitalar de Setúbal, EPE",0,0,0,2021,1,"-8.8818638,38.5283754",3
2021-01-01,Região de Saúde LVT,"Centro Hospitalar Universitário de Lisboa Norte, EPE",129,0,129,2021,1,"-9.1616116,38.7500861",3
2021-01-01,Região de Saúde LVT,Centro Hospitalar Psiquiátrico de Lisboa,28,847,875,2021,1,"-9.1460705,38.7569771",3
2021-01-01,Região de Saúde Norte,"Centro Hospitalar Universitário do Porto, EPE",133,0,133,2021,1,"-8.6172617,41.1472498",1
2021-01-01,Região de Saúde Norte,"Centro Hospitalar Entre Douro e Vouga, EPE",17,3,20,2021,1,"-8.5458794,40.9293884",1
2021-01-01,Região de Saúde Norte,"Centro Hospitalar Trás-os-Montes e Alto Douro, EPE",30,0,30,2021,1,"-7.7515252,41.3031784",1
2021-01-01,Região de Saúde Norte,"Centro Hospitalar Vila Nova de Gaia/Espinho, EPE",80,0,80,2021,1,"-8.5972617,41.1094138",1
2021-02-01,Região de Saúde do Alentejo,"Hospital Espírito Santo de Évora, EPE",163,22,185,2021,2,"-7.9032848,38.5684861",4
2021-02-01,Região de Saúde do Centro,"Centro Hospitalar e Universitário de Coimbra, EPE",4767,36113,40880,2021,2,"-8.4098211,40.2191523",2
2021-02-01,Região de Saúde do Centro,"Unidade Local de Saúde de Castelo Branco, EPE",89,53,142,2021,2,"-7.4981271,39.8212263",2
2021-02-01,Região de Saúde LVT,"Centro Hospitalar do Oeste, EPE, EPE",1823,7224,9047,2021,2,"-9.1258493,39.4054629",3
2021-02-01,Região de Saúde LVT,"Centro Hospitalar Médio Tejo, EPE",0,0,0,2021,2,"-8.5404429,39.478072",3
2021-02-01,Região de Saúde Norte,"Hospital de Magalhães Lemos, EPE",0,2200,2200,2021,2,"-8.6649823,41.1764649",1
2021-03-01,Região de Saúde do Alentejo,"Unidade Local de Saúde do Norte Alentejano, EPE",57,39,96,2021,3,"-7.4263845,39.3003425",4
2021-03-01,Região de Saúde do Centro,"Hospital Distrital da Figueira da Foz, EPE",1288,3913,5201,2021,3,"-8.8586755,40.117897",2
2021-03-01,Região de Saúde LVT,"Hospital Distrital de Santarém, EPE",0,25,25,2021,3,"-8.6937515,39.2410946",3
2021-03-01,Região de Saúde Norte,"Centro Hospitalar do Médio Ave, EPE",14,165,179,2021,3,"-8.4802503,41.3423984",1
2021-03-01,Região de Saúde Norte,"Hospital da Senhora da Oliveira, Guimarães, EPE",326,0,326,2021,3,"-8.3086907,41.4387173",1
2021-04-01,Região de Saúde do Alentejo,"Hospital Espírito Santo de Évora, EPE",381,51,432,2021,4,"-7.9032848,38.5684861",4
2021-04-01,Região de Saúde do Alentejo,"Unidade Local de Saúde do Baixo Alentejo, EPE",636,770,1406,2021,4,"-7.8721227,38.014123",4
2021-04-01,Região de Saúde do Centro,"Centro Hospitalar Tondela-Viseu, EPE",75,30,105,2021,4,"-8.0827433,40.516364",2
2021-04-01,Região de Saúde LVT,"Centro Hospitalar Barreiro/Montijo, EPE",1,28,29,2021,4,"-9.0592392,38.6554005",3
2021-04-01,Região de Saúde LVT,"Centro Hospitalar Universitário Lisboa Central, EPE",1999,1068,3067,2021,4,"-9.1371248,38.7166948",3
2021-04-01,Região de Saúde LVT,"Centro Hospitalar Universitário de Lisboa Norte, EPE",979,209,1188,2021,4,"-9.1616116,38.7500861",3
2021-04-01,Região de Saúde LVT,"Centro Hospitalar Médio Tejo, EPE",0,0,0,2021,4,"-8.5404429,39.478072",3
2021-04-01,Região de Saúde LVT,Centro Hospitalar Psiquiátrico de Lisboa,202,3303,3505,2021,4,"-9.1460705,38.7569771",3
2021-04-01,Região de Saúde LVT,"Hospital Garcia de Orta, EPE",10,2,12,2021,4,"-9.1822554,38.6658713",3
2021-04-01,Região de Saúde Norte,"Centro Hospitalar Póvoa de Varzim/Vila do Conde, EPE",235,186,421,2021,4,"-8.7589945,41.3828711",1
2021-04-01,Região de Saúde Norte,"Centro Hospitalar Vila Nova de Gaia/Espinho, EPE",367,0,367,2021,4,"-8.5972617,41.1094138",1
2021-04-01,Região de Saúde Norte,"Unidade Local de Saúde de Matosinhos, EPE",0,3291,3291,2021,4,"-8.6745115,41.1794456",1
2021-05-01,Região de Saúde do Centro,"Centro Hospitalar e Universitário de Coimbra, EPE",14919,71497,86416,2021,5,"-8.4098211,40.2191523",2
2021-05-01,Região de Saúde do Centro,"Hospital Distrital da Figueira da Foz, EPE",1995,4863,6858,2021,5,"-8.8586755,40.117897",2
2021-05-01,Região de Saúde LVT,"Centro Hospitalar de Lisboa Ocidental, EPE",56,0,56,2021,5,"-9.216985,38.708454",3
2021-05-01,Região de Saúde LVT,"Centro Hospitalar de Setúbal, EPE",383,263,646,2021,5,"-8.8818638,38.5283754",3
2021-05-01,Região de Saúde LVT,"Centro Hospitalar do Oeste, EPE, EPE",3437,16780,20217,2021,5,"-9.1258493,39.4054629",3
2021-05-01,Região de Saúde LVT,"Hospital Professor Doutor Fernando Fonseca, EPE",2,17,19,2021,5,"-9.2264834,38.7422257",3
2021-05-01,Região de Saúde LVT,"Hospital Garcia de Orta, EPE",16,3,19,2021,5,"-9.1822554,38.6658713",3
2021-05-01,Região de Saúde Norte,"Centro Hospitalar do Médio Ave, EPE",35,403,438,2021,5,"-8.4802503,41.3423984",1
2021-05-01,Região de Saúde Norte,"Centro Hospitalar Póvoa de Varzim/Vila do Conde, EPE",287,193,480,2021,5,"-8.7589945,41.3828711",1
2021-06-01,Região de Saúde do Centro,"Centro Hospitalar de Leiria, EPE",164,118,282,2021,6,"-8.7982706,39.7414812",2
2021-06-01,Região de Saúde do Centro,"Centro Hospitalar e Universitário de Coimbra, EPE",17544,78712,96256,2021,6,"-8.4098211,40.2191523",2
2021-06-01,Região de Saúde LVT,"Hospital Garcia de Orta, EPE",23,3,26,2021,6,"-9.1822554,38.6658713",3
2021-06-01,Região de Saúde Norte,"Centro Hospitalar Entre Douro e Vouga, EPE",57,13,70,2021,6,"-8.5458794,40.9293884",1
2021-06-01,Região de Saúde Norte,"Centro Hospitalar Póvoa de Varzim/Vila do Conde, EPE",335,202,537,2021,6,"-8.7589945,41.3828711",1
2021-07-01,Região de Saúde do Alentejo,"Unidade Local de Saúde do Litoral Alentejano, EPE",11,0,11,2021,7,"-8.6956768,38.0162314",4
2021-07-01,Região de Saúde do Centro,"Unidade Local de Saúde de Castelo Branco, EPE",129,105,234,2021,7,"-7.4981271,39.8212263",2
2021-07-01,Região de Saúde Norte,"Unidade Local de Saúde do Alto Minho, EPE",1,1,2,2021,7,"-8.8252713,41.7056054",1
2021-08-01,Região de Saúde do Alentejo,"Unidade Local de Saúde do Litoral Alentejano, EPE",11,0,11,2021,8,"-8.6956768,38.0162314",4
2021-08-01,Região de Saúde do Centro,Hospital Arcebispo João Crisóstomo,77,0,77,2021,8,"-8.5933462,40.3470015",2
2021-08-01,Região de Saúde do Centro,"Unidade Local de Saúde de Castelo Branco, EPE",133,109,242,2021,8,"-7.4981271,39.8212263",2
2021-08-01,Região de Saúde LVT,"Hospital Garcia de Orta, EPE",418,2376,2794,2021,8,"-9.1822554,38.6658713",3
2021-08-01,Região de Saúde Norte,"Centro Hospitalar do Médio Ave, EPE",69,653,722,2021,8,"-8.4802503,41.3423984",1
2021-08-01,Região de Saúde Norte,"Centro Hospitalar Póvoa de Varzim/Vila do Conde, EPE",421,218,639,2021,8,"-8.7589945,41.3828711",1
2021-08-01,Região de Saúde Norte,"Centro Hospitalar Trás-os-Montes e Alto Douro, EPE",450,1,451,2021,8,"-7.7515252,41.3031784",1
2021-08-01,Região de Saúde Norte,"Centro Hospitalar Vila Nova de Gaia/Espinho, EPE",703,0,703,2021,8,"-8.5972617,41.1094138",1
2021-09-01,Região de Saúde do Centro,"Hospital Distrital da Figueira da Foz, EPE",2888,6299,9187,2021,9,"-8.8586755,40.117897",2
2021-09-01,Região de Saúde LVT,"Centro Hospitalar Médio Tejo, EPE",0,0,0,2021,9,"-8.5404429,39.478072",3
2021-09-01,Região de Saúde Norte,"Centro Hospitalar Entre Douro e Vouga, EPE",58,14,72,2021,9,"-8.5458794,40.9293884",1
2021-09-01,Região de Saúde Norte,"Hospital da Senhora da Oliveira, Guimarães, EPE",934,0,934,2021,9,"-8.3086907,41.4387173",1
2021-09-01,Região de Saúde Norte,"Hospital de Magalhães Lemos, EPE",0,2200,2200,2021,9,"-8.6649823,41.1764649",1
2021-10-01,Região de Saúde do Alentejo,"Hospital Espírito Santo de Évora, EPE",939,116,1055,2021,10,"-7.9032848,38.5684861",4
2021-10-01,Região de Saúde do Alentejo,"Unidade Local de Saúde do Norte Alentejano, EPE",205,130,335,2021,10,"-7.4263845,39.3003425",4
2021-10-01,Região de Saúde do Centro,"Centro Hospitalar Tondela-Viseu, EPE",183,60,243,2021,10,"-8.0827433,40.516364",2
2021-10-01,Região de Saúde LVT,"Centro Hospitalar de Setúbal, EPE",652,418,1070,2021,10,"-8.8818638,38.5283754",3
2021-10-01,Região de Saúde LVT,"Centro Hospitalar Médio Tejo, EPE",0,0,0,2021,10,"-8.5404429,39.478072",3
2021-10-01,Região de Saúde LVT,"Hospital Distrital de Santarém, EPE",4,36,40,2021,10,"-8.6937515,39.2410946",3
2021-10-01,Região de Saúde LVT,"Hospital Garcia de Orta, EPE",835,7809,8644,2021,10,"-9.1822554,38.6658713",3
2021-10-01,Região de Saúde Norte,"Centro Hospitalar Universitário de São João, EPE",0,0,0,2021,10,"-8.6010558,41.1831056",1
2021-10-01,Região de Saúde Norte,"Hospital da Senhora da Oliveira, Guimarães, EPE",1053,0,1053,2021,10,"-8.3086907,41.4387173",1
2021-10-01,Região de Saúde Norte,"Unidade Local de Saúde de Matosinhos, EPE",0,7801,7801,2021,10,"-8.6745115,41.1794456",1
2021-10-01,Região de Saúde Norte,"Unidade Local de Saúde do Alto Minho, EPE",15,5,20,2021,10,"-8.8252713,41.7056054",1
2021-11-01,Região de Saúde do Alentejo,"Hospital Espírito Santo de Évora, EPE",1064,123,1187,2021,11,"-7.9032848,38.5684861",4
2021-11-01,Região de Saúde do Centro,"Centro Hospitalar de Leiria, EPE",284,203,487,2021,11,"-8.7982706,39.7414812",2
2021-11-01,Região de Saúde do Centro,"Centro Hospitalar e Universitário de Coimbra, EPE",28855,111371,140226,2021,11,"-8.4098211,40.2191523",2
2021-11-01,Região de Saúde LVT,"Centro Hospitalar Barreiro/Montijo, EPE",9,105,114,2021,11,"-9.0592392,38.6554005",3
2021-11-01,Região de Saúde LVT,"Centro Hospitalar Universitário de Lisboa Norte, EPE",4133,830,4963,2021,11,"-9.1616116,38.7500861",3
2021-11-01,Região de Saúde Norte,"Centro Hospitalar Vila Nova de Gaia/Espinho, EPE",1158,0,1158,2021,11,"-8.5972617,41.1094138",1
2021-12-01,Região de Saúde do Alentejo,"Hospital Espírito Santo de Évora, EPE",1165,129,1294,2021,12,"-7.9032848,38.5684861",4
2021-12-01,Região de Saúde do Alentejo,"Unidade Local de Saúde do Norte Alentejano, EPE",262,152,414,2021,12,"-7.4263845,39.3003425",4
2021-12-01,Região de Saúde do Centro,"Centro Hospitalar Tondela-Viseu, EPE",322,87,409,2021,12,"-8.0827433,40.516364",2
2021-12-01,Região de Saúde do Centro,Centro Medicina de Reabilitação da Região Centro Rovisco Pais,1,2,3,2021,12,"-8.7707806,40.297919",2
2021-12-01,Região de Saúde do Centro,Hospital Arcebispo João Crisóstomo,95,0,95,2021,12,"-8.5933462,40.3470015",2
2021-12-01,Região de Saúde LVT,"Centro Hospitalar Universitário de Lisboa Norte, EPE",4526,834,5360,2021,12,"-9.1616116,38.7500861",3
2021-12-01,Região de Saúde LVT,"Hospital Distrital de Santarém, EPE",3,38,41,2021,12,"-8.6937515,39.2410946",3
2021-12-01,Região de Saúde Norte,"Centro Hospitalar Vila Nova de Gaia/Espinho, EPE",1219,0,1219,2021,12,"-8.5972617,41.1094138",1
2022-01-01,Região de Saúde do Alentejo,"Unidade Local de Saúde do Norte Alentejano, EPE",55,3,58,2022,1,"-7.4263845,39.3003425",4
2022-01-01,Região de Saúde do Centro,"Centro Hospitalar do Baixo Vouga, EPE",31,43,74,2022,1,"-8.6543716,40.6362453",2
2022-01-01,Região de Saúde do Centro,Centro Medicina de Reabilitação da Região Centro Rovisco Pais,4,0,4,2022,1,"-8.7707806,40.297919",2
2022-01-01,Região de Saúde do Centro,Hospital Arcebispo João Crisóstomo,2,0,2,2022,1,"-8.5933462,40.3470015",2
2022-01-01,Região de Saúde LVT,"Centro Hospitalar do Oeste, EPE, EPE",806,1864,2670,2022,1,"-9.1258493,39.4054629",3
2022-01-01,Região de Saúde LVT,"Hospital Distrital de Santarém, EPE",0,1,1,2022,1,"-8.6937515,39.2410946",3
2022-01-01,Região de Saúde LVT,"Hospital Professor Doutor Fernando Fonseca, EPE",455,3689,4144,2022,1,"-9.2264834,38.7422257",3
2022-01-01,Região de Saúde LVT,"Hospital Garcia de Orta, EPE",266,2387,2653,2022,1,"-9.1822554,38.6658713",3
2022-01-01,Região de Saúde Norte,"Centro Hospitalar do Médio Ave, EPE",16,513,529,2022,1,"-8.4802503,41.3423984",1
2022-01-01,Região de Saúde Norte,"Centro Hospitalar Entre Douro e Vouga, EPE",44,36,80,2022,1,"-8.5458794,40.9293884",1
2022-01-01,Região de Saúde Norte,"Centro Hospitalar Póvoa de Varzim/Vila do Conde, EPE",34,5,39,2022,1,"-8.7589945,41.3828711",1
2022-01-01,Região de Saúde Norte,"Hospital de Magalhães Lemos, EPE",0,386,386,2022,1,"-8.6649823,41.1764649",1
2022-02-01,Região de Saúde do Alentejo,"Hospital Espírito Santo de Évora, EPE",225,27,252,2022,2,"-7.9032848,38.5684861",4
2022-02-01,Região de Saúde do Alentejo,"Unidade Local de Saúde do Baixo Alentejo, EPE",374,239,613,2022,2,"-7.8721227,38.014123",4
2022-02-01,Região de Saúde do Centro,"Centro Hospitalar do Baixo Vouga, EPE",69,82,151,2022,2,"-8.6543716,40.6362453",2
2022-02-01,Região de Saúde do Centro,"Centro Hospitalar e Universitário de Coimbra, EPE",489,413,902,2022,2,"-8.4098211,40.2191523",2
2022-02-01,Região de Saúde do Centro,"Hospital Distrital da Figueira da Foz, EPE",515,911,1426,2022,2,"-8.8586755,40.117897",2
2022-02-01,Região de Saúde LVT,"Centro Hospitalar Universitário Lisboa Central, EPE",573,463,1036,2022,2,"-9.1371248,38.7166948",3
2022-02-01,Região de Saúde LVT,"Centro Hospitalar do Oeste, EPE, EPE",1567,3577,5144,2022,2,"-9.1258493,39.4054629",3
2022-02-01,Região de Saúde LVT,"Hospital Distrital de Santarém, EPE",1,2,3,2022,2,"-8.6937515,39.2410946",3
2022-02-01,Região de Saúde Norte,"Hospital de Magalhães Lemos, EPE",0,654,654,2022,2,"-8.6649823,41.1764649",1
2022-02-01,Região de Saúde Norte,"Unidade Local de Saúde do Alto Minho, EPE",11,12,23,2022,2,"-8.8252713,41.7056054",1
2022-03-01,Região de Saúde do Centro,"Centro Hospitalar Universitário Cova da Beira, EPE",1852,4610,6462,2022,3,"-7.4922407,40.2804158",2
2022-03-01,Região de Saúde do Centro,"Centro Hospitalar e Universitário de Coimbra, EPE",796,700,1496,2022,3,"-8.4098211,40.2191523",2
2022-03-01,Região de Saúde do Centro,Hospital Arcebispo João Crisóstomo,14,0,14,2022,3,"-8.5933462,40.3470015",2
2022-03-01,Região de Saúde do Centro,"Hospital Distrital da Figueira da Foz, EPE",795,1299,2094,2022,3,"-8.8586755,40.117897",2
2022-03-01,Região de Saúde do Centro,"Unidade Local de Saúde de Castelo Branco, EPE",1166,1458,2624,2022,3,"-7.4981271,39.8212263",2
2022-03-01,Região de Saúde LVT,"Centro Hospitalar Universitário de Lisboa Norte, EPE",1370,241,1611,2022,3,"-9.1616116,38.7500861",3
2022-03-01,Região de Saúde LVT,"Hospital Garcia de Orta, EPE",666,5970,6636,2022,3,"-9.1822554,38.6658713",3
2022-03-01,Região de Saúde Norte,"Centro Hospitalar Universitário de São João, EPE",0,0,0,2022,3,"-8.6010558,41.1831056",1
2022-03-01,Região de Saúde Norte,"Centro Hospitalar Entre Douro e Vouga, EPE",61,36,97,2022,3,"-8.5458794,40.9293884",1
2022-03-01,Região de Saúde Norte,"Centro Hospitalar Trás-os-Montes e Alto Douro, EPE",69,0,69,2022,3,"-7.7515252,41.3031784",1
2022-04-01,Região de Saúde do Alentejo,"Unidade Local de Saúde do Baixo Alentejo, EPE",713,387,1100,2022,4,"-7.8721227,38.014123",4
2022-04-01,Região de Saúde do Alentejo,"Unidade Local de Saúde do Litoral Alentejano, EPE",10,0,10,2022,4,"-8.6956768,38.0162314",4
2022-04-01,Região de Saúde do Algarve,"Centro Hospitalar Universitário do Algarve,EPE",0,0,0,2022,4,"-7.9281554,37.0238973",5
2022-04-01,Região de Saúde do Centro,Centro Medicina de Reabilitação da Região Centro Rovisco Pais,7,1,8,2022,4,"-8.7707806,40.297919",2
2022-04-01,Região de Saúde LVT,"Centro Hospitalar de Lisboa Ocidental, EPE",113,677,790,2022,4,"-9.216985,38.708454",3
2022-04-01,Região de Saúde Norte,"Centro Hospitalar Entre Douro e Vouga, EPE",61,36,97,2022,4,"-8.5458794,40.9293884",1
2022-04-01,Região de Saúde Norte,"Centro Hospitalar Trás-os-Montes e Alto Douro, EPE",79,0,79,2022,4,"-7.7515252,41.3031784",1
2022-05-01,Região de Saúde do Alentejo,"Hospital Espírito Santo de Évora, EPE",610,83,693,2022,5,"-7.9032848,38.5684861",4
2022-05-01,Região de Saúde do Centro,"Centro Hospitalar de Leiria, EPE",132,92,224,2022,5,"-8.7982706,39.7414812",2
2022-05-01,Região de Saúde do Centro,Hospital Arcebispo João Crisóstomo,24,0,24,2022,5,"-8.5933462,40.3470015",2
2022-05-01,Região de Saúde do Centro,"Hospital Distrital da Figueira da Foz, EPE",1273,1946,3219,2022,5,"-8.8586755,40.117897",2
2022-05-01,Região de Saúde LVT,"Centro Hospitalar de Lisboa Ocidental, EPE",130,872,1002,2022,5,"-9.216985,38.708454",3
2022-05-01,Região de Saúde LVT,"Centro Hospitalar de Setúbal, EPE",390,443,833,2022,5,"-8.8818638,38.5283754",3
2022-05-01,Região de Saúde LVT,"Hospital Garcia de Orta, EPE",927,8606,9533,2022,5,"-9.1822554,38.6658713",3
2022-05-01,Região de Saúde Norte,"Centro Hospitalar Póvoa de Varzim/Vila do Conde, EPE",196,6,202,2022,5,"-8.7589945,41.3828711",1
2022-05-01,Região de Saúde Norte,"Centro Hospitalar Vila Nova de Gaia/Espinho, EPE",245,0,245,2022,5,"-8.5972617,41.1094138",1
2022-05-01,Região de Saúde Norte,"Hospital de Braga, EPE",428,0,428,2022,5,"-8.398982,41.56785",1
2022-05-01,Região de Saúde Norte,"Unidade Local de Saúde do Alto Minho, EPE",15,28,43,2022,5,"-8.8252713,41.7056054",1
2022-06-01,Região de Saúde do Centro,"Centro Hospitalar de Leiria, EPE",158,100,258,2022,6,"-8.7982706,39.7414812",2
2022-06-01,Região de Saúde do Centro,"Unidade Local de Saúde de Castelo Branco, EPE",2350,2850,5200,2022,6,"-7.4981271,39.8212263",2
2022-06-01,Região de Saúde LVT,"Hospital Garcia de Orta, EPE",1048,9909,10957,2022,6,"-9.1822554,38.6658713",3
2022-06-01,Região de Saúde Norte,"Centro Hospitalar Universitário de São João, EPE",0,0,0,2022,6,"-8.6010558,41.1831056",1
2022-06-01,Região de Saúde Norte,"Centro Hospitalar Póvoa de Varzim/Vila do Conde, EPE",225,6,231,2022,6,"-8.7589945,41.3828711",1
2022-06-01,Região de Saúde Norte,"Centro Hospitalar Trás-os-Montes e Alto Douro, EPE",148,0,148,2022,6,"-7.7515252,41.3031784",1
2022-06-01,Região de Saúde Norte,"Hospital de Braga, EPE",469,0,469,2022,6,"-8.398982,41.56785",1
2022-06-01,Região de Saúde Norte,"Instituto Português Oncologia do Porto, EPE",59,84,143,2022,6,"-8.6062881,41.1785642",1
2022-07-01,Região de Saúde do Alentejo,"Hospital Espírito Santo de Évora, EPE",770,114,884,2022,7,"-7.9032848,38.5684861",4
2022-07-01,Região de Saúde do Algarve,"Centro Hospitalar Universitário do Algarve,EPE",0,0,0,2022,7,"-7.9281554,37.0238973",5
2022-07-01,Região de Saúde do Centro,"Centro Hospitalar Universitário Cova da Beira, EPE",3964,9951,13915,2022,7,"-7.4922407,40.2804158",2
2022-07-01,Região de Saúde LVT,"Centro Hospitalar de Setúbal, EPE",462,588,1050,2022,7,"-8.8818638,38.5283754",3
2022-07-01,Região de Saúde LVT,"Hospital Distrital de Santarém, EPE",2,41,43,2022,7,"-8.6937515,39.2410946",3
2022-07-01,Região de Saúde LVT,"Hospital Professor Doutor Fernando Fonseca, EPE",2273,20781,23054,2022,7,"-9.2264834,38.7422257",3
2022-07-01,Região de Saúde Norte,"Centro Hospitalar Universitário de São João, EPE",0,0,0,2022,7,"-8.6010558,41.1831056",1
2022-07-01,Região de Saúde Norte,"Instituto Português Oncologia do Porto, EPE",76,97,173,2022,7,"-8.6062881,41.1785642",1
2022-07-01,Região de Saúde Norte,"Unidade Local de Saúde do Alto Minho, EPE",15,36,51,2022,7,"-8.8252713,41.7056054",1
2022-08-01,Região de Saúde do Alentejo,"Unidade Local de Saúde do Baixo Alentejo, EPE",1275,665,1940,2022,8,"-7.8721227,38.014123",4
2022-08-01,Região de Saúde do Alentejo,"Unidade Local de Saúde do Litoral Alentejano, EPE",17,0,17,2022,8,"-8.6956768,38.0162314",4
2022-08-01,Região de Saúde do Alentejo,"Unidade Local de Saúde do Norte Alentejano, EPE",465,128,593,2022,8,"-7.4263845,39.3003425",4
2022-08-01,Região de Saúde do Centro,"Centro Hospitalar do Baixo Vouga, EPE",313,254,567,2022,8,"-8.6543716,40.6362453",2
2022-08-01,Região de Saúde LVT,"Centro Hospitalar Barreiro/Montijo, EPE",1012,1592,2604,2022,8,"-9.0592392,38.6554005",3
2022-08-01,Região de Saúde LVT,"Centro Hospitalar de Lisboa Ocidental, EPE",174,1257,1431,2022,8,"-9.216985,38.708454",3
2022-08-01,Região de Saúde LVT,"Centro Hospitalar de Setúbal, EPE",493,633,1126,2022,8,"-8.8818638,38.5283754",3
2022-08-01,Região de Saúde Norte,"Hospital da Senhora da Oliveira, Guimarães, EPE",746,0,746,2022,8,"-8.3086907,41.4387173",1
2022-08-01,Região de Saúde Norte,"Hospital de Magalhães Lemos, EPE",0,1930,1930,2022,8,"-8.6649823,41.1764649",1
2022-08-01,Região de Saúde Norte,"Unidade Local de Saúde de Matosinhos, EPE",0,5647,5647,2022,8,"-8.6745115,41.1794456",1
2022-09-01,Região de Saúde do Alentejo,"Hospital Espírito Santo de Évora, EPE",968,155,1123,2022,9,"-7.9032848,38.5684861",4
2022-09-01,Região de Saúde do Alentejo,"Unidade Local de Saúde do Baixo Alentejo, EPE",1375,727,2102,2022,9,"-7.8721227,38.014123",4
2022-09-01,Região de Saúde do Alentejo,"Unidade Local de Saúde do Norte Alentejano, EPE",506,146,652,2022,9,"-7.4263845,39.3003425",4
2022-09-01,Região de Saúde do Centro,"Centro Hospitalar Universitário Cova da Beira, EPE",4751,12178,16929,2022,9,"-7.4922407,40.2804158",2
2022-09-01,Região de Saúde do Centro,"Centro Hospitalar de Leiria, EPE",238,159,397,2022,9,"-8.7982706,39.7414812",2
2022-09-01,Região de Saúde do Centro,"Centro Hospitalar do Baixo Vouga, EPE",373,290,663,2022,9,"-8.6543716,40.6362453",2
2022-09-01,Região de Saúde do Centro,"Centro Hospitalar Tondela-Viseu, EPE",202,81,283,2022,9,"-8.0827433,40.516364",2
2022-09-01,Região de Saúde do Centro,Hospital Arcebispo João Crisóstomo,51,0,51,2022,9,"-8.5933462,40.3470015",2
2022-09-01,Região de Saúde LVT,"Centro Hospitalar Barreiro/Montijo, EPE",1175,1843,3018,2022,9,"-9.0592392,38.6554005",3
2022-09-01,Região de Saúde LVT,"Centro Hospitalar de Lisboa Ocidental, EPE",197,1416,1613,2022,9,"-9.216985,38.708454",3
2022-09-01,Região de Saúde LVT,"Hospital de Vila Franca de Xira, EPE",231,6824,7055,2022,9,"-8.984506,38.977235",3
2022-09-01,Região de Saúde LVT,"Hospital Garcia de Orta, EPE",1484,13922,15406,2022,9,"-9.1822554,38.6658713",3
2022-09-01,Região de Saúde Norte,"Centro Hospitalar do Médio Ave, EPE",168,3495,3663,2022,9,"-8.4802503,41.3423984",1
2022-09-01,Região de Saúde Norte,"Centro Hospitalar Universitário do Porto, EPE",2638,0,2638,2022,9,"-8.6172617,41.1472498",1
2022-10-01,Região de Saúde do Alentejo,"Unidade Local de Saúde do Baixo Alentejo, EPE",1475,777,2252,2022,10,"-7.8721227,38.014123",4
2022-10-01,Região de Saúde do Algarve,"Centro Hospitalar Universitário do Algarve,EPE",0,0,0,2022,10,"-7.9281554,37.0238973",5
2022-10-01,Região de Saúde do Centro,"Centro Hospitalar Universitário Cova da Beira, EPE",5136,13344,18480,2022,10,"-7.4922407,40.2804158",2
2022-10-01,Região de Saúde do Centro,Centro Medicina de Reabilitação da Região Centro Rovisco Pais,50,10,60,2022,10,"-8.7707806,40.297919",2
2022-10-01,Região de Saúde do Centro,Hospital Arcebispo João Crisóstomo,57,0,57,2022,10,"-8.5933462,40.3470015",2
2022-10-01,Região de Saúde LVT,"Centro Hospitalar Universitário Lisboa Central, EPE",883,3148,4031,2022,10,"-9.1371248,38.7166948",3
2022-10-01,Região de Saúde Norte,"Centro Hospitalar Universitário do Porto, EPE",2886,0,2886,2022,10,"-8.6172617,41.1472498",1
2022-10-01,Região de Saúde Norte,"Centro Hospitalar Vila Nova de Gaia/Espinho, EPE",613,0,613,2022,10,"-8.5972617,41.1094138",1
2022-10-01,Região de Saúde Norte,"Unidade Local de Saúde de Matosinhos, EPE",0,7009,7009,2022,10,"-8.6745115,41.1794456",1
2022-11-01,Região de Saúde do Centro,"Centro Hospitalar Tondela-Viseu, EPE",270,104,374,2022,11,"-8.0827433,40.516364",2
2022-11-01,Região de Saúde do Centro,"Hospital Distrital da Figueira da Foz, EPE",1823,3260,5083,2022,11,"-8.8586755,40.117897",2
2022-11-01,Região de Saúde LVT,"Centro Hospitalar de Setúbal, EPE",565,762,1327,2022,11,"-8.8818638,38.5283754",3
2022-11-01,Região de Saúde LVT,"Centro Hospitalar do Oeste, EPE, EPE",8289,16378,24667,2022,11,"-9.1258493,39.4054629",3
2022-11-01,Região de Saúde LVT,"Centro Hospitalar Médio Tejo, EPE",0,0,0,2022,11,"-8.5404429,39.478072",3
2022-11-01,Região de Saúde Norte,"Hospital de Magalhães Lemos, EPE",0,4311,4311,2022,11,"-8.6649823,41.1764649",1
2022-12-01,Região de Saúde do Alentejo,"Unidade Local de Saúde do Litoral Alentejano, EPE",23,0,23,2022,12,"-8.6956768,38.0162314",4
2022-12-01,Região de Saúde LVT,"Centro Hospitalar do Oeste, EPE, EPE",8676,17619,26295,2022,12,"-9.1258493,39.4054629",3
2022-12-01,Região de Saúde LVT,"Hospital Professor Doutor Fernando Fonseca, EPE",3863,33667,37530,2022,12,"-9.2264834,38.7422257",3
2022-12-01,Região de Saúde LVT,"Hospital Garcia de Orta, EPE",1122,15484,16606,2022,12,"-9.1822554,38.6658713",3
2022-12-01,Região de Saúde Norte,"Centro Hospitalar Universitário de São João, EPE",0,0,0,2022,12,"-8.6010558,41.1831056",1
2022-12-01,Região de Saúde Norte,"Hospital de Braga, EPE",717,0,717,2022,12,"-8.398982,41.56785",1
2023-01-01,Região de Saúde LVT,"Centro Hospitalar Universitário Lisboa Central, EPE",68,395,463,2023,1,"-9.1371248,38.7166948",3
2023-01-01,Região de Saúde LVT,Centro Hospitalar Psiquiátrico de Lisboa,50,668,718,2023,1,"-9.1460705,38.7569771",3
2023-01-01,Região de Saúde LVT,"Hospital Distrital de Santarém, EPE",1,13,14,2023,1,"-8.6937515,39.2410946",3
2023-01-01,Região de Saúde Norte,"Centro Hospitalar Universitário de São João, EPE",0,0,0,2023,1,"-8.6010558,41.1831056",1
2023-01-01,Região de Saúde Norte,"Centro Hospitalar Trás-os-Montes e Alto Douro, EPE",18,0,18,2023,1,"-7.7515252,41.3031784",1
2023-02-01,Região de Saúde do Algarve,"Centro Hospitalar Universitário do Algarve,EPE",0,0,0,2023,2,"-7.9281554,37.0238973",5
2023-02-01,Região de Saúde do Centro,"Centro Hospitalar do Baixo Vouga, EPE",91,77,168,2023,2,"-8.6543716,40.6362453",2
2023-02-01,Região de Saúde do Centro,"Centro Hospitalar e Universitário de Coimbra, EPE",819,454,1273,2023,2,"-8.4098211,40.2191523",2
2023-02-01,Região de Saúde do Centro,Centro Medicina de Reabilitação da Região Centro Rovisco Pais,28,16,44,2023,2,"-8.7707806,40.297919",2
2023-02-01,Região de Saúde do Centro,"Hospital Distrital da Figueira da Foz, EPE",159,397,556,2023,2,"-8.8586755,40.117897",2
2023-02-01,Região de Saúde LVT,"Centro Hospitalar do Oeste, EPE, EPE",690,1594,2284,2023,2,"-9.1258493,39.4054629",3
2023-02-01,Região de Saúde LVT,"Centro Hospitalar Universitário de Lisboa Norte, EPE",1101,6,1107,2023,2,"-9.1616116,38.7500861",3
2023-02-01,Região de Saúde Norte,"Centro Hospitalar Póvoa de Varzim/Vila do Conde, EPE",73,0,73,2023,2,"-8.7589945,41.3828711",1
2023-02-01,Região de Saúde Norte,"Centro Hospitalar Trás-os-Montes e Alto Douro, EPE",37,0,37,2023,2,"-7.7515252,41.3031784",1
2023-03-01,Região de Saúde LVT,"Hospital de Vila Franca de Xira, EPE",47,0,47,2023,3,"-8.984506,38.977235",3
2023-03-01,Região de Saúde Norte,"Centro Hospitalar do Médio Ave, EPE",68,1353,1421,2023,3,"-8.4802503,41.3423984",1
2023-03-01,Região de Saúde Norte,"Centro Hospitalar Trás-os-Montes e Alto Douro, EPE",61,0,61,2023,3,"-7.7515252,41.3031784",1
2023-03-01,Região de Saúde Norte,"Hospital de Braga, EPE",180,0,180,2023,3,"-8.398982,41.56785",1
2023-03-01,Região de Saúde Norte,"Instituto Português Oncologia do Porto, EPE",53,56,109,2023,3,"-8.6062881,41.1785642",1
2023-03-01,Região de Saúde Norte,"Unidade Local de Saúde do Alto Minho, EPE",2,35,37,2023,3,"-8.8252713,41.7056054",1
2023-04-01,Região de Saúde do Alentejo,"Unidade Local de Saúde do Norte Alentejano, EPE",178,304,482,2023,4,"-7.4263845,39.3003425",4
2023-04-01,Região de Saúde do Centro,"Centro Hospitalar Universitário Cova da Beira, EPE",1554,4688,6242,2023,4,"-7.4922407,40.2804158",2
2023-04-01,Região de Saúde do Centro,"Centro Hospitalar Tondela-Viseu, EPE",112,32,144,2023,4,"-8.0827433,40.516364",2
2023-04-01,Região de Saúde LVT,"Hospital Garcia de Orta, EPE",229,3576,3805,2023,4,"-9.1822554,38.6658713",3
2023-04-01,Região de Saúde Norte,"Unidade Local de Saúde de Matosinhos, EPE",0,2715,2715,2023,4,"-8.6745115,41.1794456",1
2023-05-01,Região de Saúde do Centro,Centro Medicina de Reabilitação da Região Centro Rovisco Pais,99,39,138,2023,5,"-8.7707806,40.297919",2
2023-05-01,Região de Saúde LVT,"Centro Hospitalar Barreiro/Montijo, EPE",1247,1485,2732,2023,5,"-9.0592392,38.6554005",3
2023-05-01,Região de Saúde Norte,"Centro Hospitalar Universitário de São João, EPE",0,0,0,2023,5,"-8.6010558,41.1831056",1
2023-06-01,Região de Saúde do Alentejo,"Unidade Local de Saúde do Baixo Alentejo, EPE",199,399,598,2023,6,"-7.8721227,38.014123",4
2023-06-01,Região de Saúde do Alentejo,"Unidade Local de Saúde do Litoral Alentejano, EPE",12,10,22,2023,6,"-8.6956768,38.0162314",4
2023-06-01,Região de Saúde do Centro,"Centro Hospitalar Universitário Cova da Beira, EPE",2363,6963,9326,2023,6,"-7.4922407,40.2804158",2
2023-06-01,Região de Saúde do Centro,"Centro Hospitalar de Leiria, EPE",157,163,320,2023,6,"-8.7982706,39.7414812",2
2023-06-01,Região de Saúde do Centro,"Centro Hospitalar Tondela-Viseu, EPE",224,58,282,2023,6,"-8.0827433,40.516364",2
2023-06-01,Região de Saúde do Centro,Hospital Arcebispo João Crisóstomo,12,0,12,2023,6,"-8.5933462,40.3470015",2
2023-06-01,Região de Saúde LVT,"Centro Hospitalar Médio Tejo, EPE",0,0,0,2023,6,"-8.5404429,39.478072",3
2023-06-01,Região de Saúde Norte,"Centro Hospitalar Trás-os-Montes e Alto Douro, EPE",133,0,133,2023,6,"-7.7515252,41.3031784",1
2023-06-01,Região de Saúde Norte,"Centro Hospitalar Universitário de Santo António, EPE",1228,1131,2359,2023,6,"-8.6172617,41.1472498",1
2023-06-01,Região de Saúde Norte,"Hospital de Braga, EPE",327,0,327,2023,6,"-8.398982,41.56785",1
2023-06-01,Região de Saúde Norte,"Instituto Português Oncologia do Porto, EPE",88,100,188,2023,6,"-8.6062881,41.1785642",1
2023-07-01,Região de Saúde do Centro,"Hospital Distrital da Figueira da Foz, EPE",591,1467,2058,2023,7,"-8.8586755,40.117897",2
2023-07-01,Região de Saúde do Centro,"Unidade Local de Saúde de Castelo Branco, EPE",1978,3035,5013,2023,7,"-7.4981271,39.8212263",2
2023-07-01,Região de Saúde LVT,"Centro Hospitalar Universitário Lisboa Central, EPE",994,4793,5787,2023,7,"-9.1371248,38.7166948",3
2023-07-01,Região de Saúde LVT,"Centro Hospitalar de Setúbal, EPE",91,247,338,2023,7,"-8.8818638,38.5283754",3
2023-07-01,Região de Saúde LVT,"Centro Hospitalar Universitário de Lisboa Norte, EPE",4177,40,4217,2023,7,"-9.1616116,38.7500861",3
2023-07-01,Região de Saúde LVT,Centro Hospitalar Psiquiátrico de Lisboa,289,4015,4304,2023,7,"-9.1460705,38.7569771",3
2023-07-01,Região de Saúde LVT,"Hospital Professor Doutor Fernando Fonseca, EPE",1976,16907,18883,2023,7,"-9.2264834,38.7422257",3
2023-07-01,Região de Saúde Norte,"Centro Hospitalar Entre Douro e Vouga, EPE",132,77,209,2023,7,"-8.5458794,40.9293884",1
2023-07-01,Região de Saúde Norte,"Unidade Local de Saúde do Alto Minho, EPE",3,56,59,2023,7,"-8.8252713,41.7056054",1
2023-08-01,Região de Saúde do Alentejo,"Hospital Espírito Santo de Évora, EPE",606,175,781,2023,8,"-7.9032848,38.5684861",4
2023-08-01,Região de Saúde do Alentejo,"Unidade Local de Saúde do Litoral Alentejano, EPE",23,10,33,2023,8,"-8.6956768,38.0162314",4
2023-08-01,Região de Saúde do Centro,"Centro Hospitalar do Baixo Vouga, EPE",300,323,623,2023,8,"-8.6543716,40.6362453",2
2023-08-01,Região de Saúde do Centro,"Instituto Português Oncologia de Coimbra, EPE",0,17,17,2023,8,"-8.4103814,40.2162514",2
2023-08-01,Região de Saúde do Centro,"Unidade Local de Saúde de Castelo Branco, EPE",2202,3468,5670,2023,8,"-7.4981271,39.8212263",2
2023-08-01,Região de Saúde LVT,"Centro Hospitalar Barreiro/Montijo, EPE",1863,2181,4044,2023,8,"-9.0592392,38.6554005",3
2023-08-01,Região de Saúde LVT,"Centro Hospitalar de Lisboa Ocidental, EPE",186,1685,1871,2023,8,"-9.216985,38.708454",3
2023-08-01,Região de Saúde Norte,"Centro Hospitalar Entre Douro e Vouga, EPE",133,82,215,2023,8,"-8.5458794,40.9293884",1
2023-09-01,Região de Saúde do Centro,"Instituto Português Oncologia de Coimbra, EPE",0,21,21,2023,9,"-8.4103814,40.2162514",2
2023-09-01,Região de Saúde LVT,"Centro Hospitalar Universitário Lisboa Central, EPE",1437,8147,9584,2023,9,"-9.1371248,38.7166948",3
2023-09-01,Região de Saúde LVT,"Centro Hospitalar Universitário de Lisboa Norte, EPE",5204,43,5247,2023,9,"-9.1616116,38.7500861",3
2023-09-01,Região de Saúde LVT,"Centro Hospitalar Médio Tejo, EPE",0,0,0,2023,9,"-8.5404429,39.478072",3
2023-09-01,Região de Saúde LVT,"Hospital Professor Doutor Fernando Fonseca, EPE",2382,19520,21902,2023,9,"-9.2264834,38.7422257",3
2023-09-01,Região de Saúde Norte,"Centro Hospitalar Entre Douro e Vouga, EPE",137,91,228,2023,9,"-8.5458794,40.9293884",1
2023-10-01,Região de Saúde do Alentejo,"Hospital Espírito Santo de Évora, EPE",730,206,936,2023,10,"-7.9032848,38.5684861",4
2023-10-01,Região de Saúde do Alentejo,"Unidade Local de Saúde do Norte Alentejano, EPE",724,613,1337,2023,10,"-7.4263845,39.3003425",4
2023-10-01,Região de Saúde do Algarve,"Centro Hospitalar Universitário do Algarve,EPE",0,0,0,2023,10,"-7.9281554,37.0238973",5
2023-10-01,Região de Saúde do Centro,"Hospital Distrital da Figueira da Foz, EPE",801,2026,2827,2023,10,"-8.8586755,40.117897",2
2023-10-01,Região de Saúde LVT,"Centro Hospitalar Universitário Lisboa Central, EPE",1687,10911,12598,2023,10,"-9.1371248,38.7166948",3
2023-10-01,Região de Saúde LVT,"Centro Hospitalar Médio Tejo, EPE",0,0,0,2023,10,"-8.5404429,39.478072",3
2023-10-01,Região de Saúde LVT,"Hospital Garcia de Orta, EPE",488,8802,9290,2023,10,"-9.1822554,38.6658713",3
2023-10-01,Região de Saúde Norte,"Centro Hospitalar Entre Douro e Vouga, EPE",166,104,270,2023,10,"-8.5458794,40.9293884",1
2023-10-01,Região de Saúde Norte,"Centro Hospitalar Universitário de Santo António, EPE",2312,1969,4281,2023,10,"-8.6172617,41.1472498",1
2023-11-01,Região de Saúde do Alentejo,"Unidade Local de Saúde do Baixo Alentejo, EPE",318,627,945,2023,11,"-7.8721227,38.014123",4
2023-11-01,Região de Saúde do Centro,"Centro Hospitalar de Leiria, EPE",279,271,550,2023,11,"-8.7982706,39.7414812",2
2023-11-01,Região de Saúde do Centro,"Hospital Distrital da Figueira da Foz, EPE",898,2262,3160,2023,11,"-8.8586755,40.117897",2
2023-11-01,Região de Saúde do Centro,"Instituto Português Oncologia de Coimbra, EPE",0,27,27,2023,11,"-8.4103814,40.2162514",2
2023-11-01,Região de Saúde do Centro,"Unidade Local de Saúde de Castelo Branco, EPE",3068,4979,8047,2023,11,"-7.4981271,39.8212263",2
2023-11-01,Região de Saúde LVT,"Centro Hospitalar de Lisboa Ocidental, EPE",484,2434,2918,2023,11,"-9.216985,38.708454",3
2023-11-01,Região de Saúde LVT,"Centro Hospitalar do Oeste, EPE, EPE",4511,8553,13064,2023,11,"-9.1258493,39.4054629",3
2023-11-01,Região de Saúde LVT,"Centro Hospitalar Médio Tejo, EPE",0,0,0,2023,11,"-8.5404429,39.478072",3
2023-11-01,Região de Saúde LVT,Centro Hospitalar Psiquiátrico de Lisboa,453,6218,6671,2023,11,"-9.1460705,38.7569771",3
2023-11-01,Região de Saúde Norte,"Centro Hospitalar Universitário de Santo António, EPE",2828,2191,5019,2023,11,"-8.6172617,41.1472498",1
2023-12-01,Região de Saúde do Centro,"Centro Hospitalar Universitário Cova da Beira, EPE",4492,13574,18066,2023,12,"-7.4922407,40.2804158",2
2023-12-01,Região de Saúde do Centro,"Centro Hospitalar do Baixo Vouga, EPE",463,483,946,2023,12,"-8.6543716,40.6362453",2
2023-12-01,Região de Saúde LVT,"Hospital Professor Doutor Fernando Fonseca, EPE",3168,26839,30007,2023,12,"-9.2264834,38.7422257",3
2023-12-01,Região de Saúde LVT,"Hospital Garcia de Orta, EPE",581,10529,11110,2023,12,"-9.1822554,38.6658713",3
2023-12-01,Região de Saúde Norte,"Unidade Local de Saúde de Matosinhos, EPE",0,8042,8042,2023,12,"-8.6745115,41.1794456",1
2013-01-01,Região de Saúde do Centro,"Centro Hospitalar Universitário Cova da Beira, EPE",33,10,43,2013,1,"-7.4922407,40.2804158",2
2013-01-01,Região de Saúde LVT,"Centro Hospitalar de Setúbal, EPE",0,0,0,2013,1,"-8.8818638,38.5283754",3
2013-02-01,Região de Saúde do Alentejo,"Unidade Local de Saúde do Baixo Alentejo, EPE",7,4,11,2013,2,"-7.8721227,38.014123",4
2013-02-01,Região de Saúde do Algarve,"Centro Hospitalar Universitário do Algarve,EPE",123,24,147,2013,2,"-7.9281554,37.0238973",5
2013-03-01,Região de Saúde do Alentejo,"Unidade Local de Saúde do Norte Alentejano, EPE",242,274,516,2013,3,"-7.4263845,39.3003425",4
2013-03-01,Região de Saúde do Algarve,"Centro Hospitalar Universitário do Algarve,EPE",138,29,167,2013,3,"-7.9281554,37.0238973",5
2013-03-01,Região de Saúde do Centro,"Centro Hospitalar Universitário Cova da Beira, EPE",65,31,96,2013,3,"-7.4922407,40.2804158",2
2013-03-01,Região de Saúde do Centro,"Centro Hospitalar e Universitário de Coimbra, EPE",302,212,514,2013,3,"-8.4098211,40.2191523",2
2013-03-01,Região de Saúde LVT,"Centro Hospitalar de Setúbal, EPE",0,0,0,2013,3,"-8.8818638,38.5283754",3
2013-03-01,Região de Saúde Norte,"Unidade Local de Saúde de Matosinhos, EPE",430,0,430,2013,3,"-8.6745115,41.1794456",1
2013-04-01,Região de Saúde do Alentejo,"Hospital Espírito Santo de Évora, EPE",391,186,577,2013,4,"-7.9032848,38.5684861",4
2013-04-01,Região de Saúde do Alentejo,"Unidade Local de Saúde do Norte Alentejano, EPE",266,365,631,2013,4,"-7.4263845,39.3003425",4
2013-04-01,Região de Saúde do Centro,"Centro Hospitalar do Baixo Vouga, EPE",159,142,301,2013,4,"-8.6543716,40.6362453",2
2013-04-01,Região de Saúde do Centro,"Unidade Local de Saúde de Castelo Branco, EPE",48,33,81,2013,4,"-7.4981271,39.8212263",2
2013-05-01,Região de Saúde do Alentejo,"Unidade Local de Saúde do Baixo Alentejo, EPE",15,11,26,2013,5,"-7.8721227,38.014123",4
2013-05-01,Região de Saúde do Alentejo,"Unidade Local de Saúde do Norte Alentejano, EPE",378,468,846,2013,5,"-7.4263845,39.3003425",4
2013-05-01,Região de Saúde do Centro,"Centro Hospitalar Universitário Cova da Beira, EPE",116,50,166,2013,5,"-7.4922407,40.2804158",2
2013-05-01,Região de Saúde LVT,"Centro Hospitalar de Setúbal, EPE",0,0,0,2013,5,"-8.8818638,38.5283754",3
2013-06-01,Região de Saúde do Algarve,"Centro Hospitalar Universitário do Algarve,EPE",309,74,383,2013,6,"-7.9281554,37.0238973",5
2013-07-01,Região de Saúde do Alentejo,"Unidade Local de Saúde do Norte Alentejano, EPE",485,621,1106,2013,7,"-7.4263845,39.3003425",4
2013-07-01,Região de Saúde do Centro,"Centro Hospitalar Tondela-Viseu, EPE",178,139,317,2013,7,"-8.0827433,40.516364",2
2013-07-01,Região de Saúde LVT,"Hospital Professor Doutor Fernando Fonseca, EPE",0,0,0,2013,7,"-9.2264834,38.7422257",3
2013-08-01,Região de Saúde do Alentejo,"Unidade Local de Saúde do Norte Alentejano, EPE",595,674,1269,2013,8,"-7.4263845,39.3003425",4
2013-09-01,Região de Saúde do Alentejo,"Hospital Espírito Santo de Évora, EPE",810,422,1232,2013,9,"-7.9032848,38.5684861",4
2013-09-01,Região de Saúde do Centro,"Centro Hospitalar e Universitário de Coimbra, EPE",1348,975,2323,2013,9,"-8.4098211,40.2191523",2
2013-09-01,Região de Saúde do Centro,"Centro Hospitalar Tondela-Viseu, EPE",207,184,391,2013,9,"-8.0827433,40.516364",2
2013-09-01,Região de Saúde LVT,"Hospital Professor Doutor Fernando Fonseca, EPE",0,0,0,2013,9,"-9.2264834,38.7422257",3
2013-09-01,Região de Saúde Norte,"Centro Hospitalar Trás-os-Montes e Alto Douro, EPE",422,0,422,2013,9,"-7.7515252,41.3031784",1
2013-10-01,Região de Saúde do Alentejo,"Unidade Local de Saúde do Norte Alentejano, EPE",791,816,1607,2013,10,"-7.4263845,39.3003425",4
2013-10-01,Região de Saúde do Centro,"Centro Hospitalar do Baixo Vouga, EPE",432,410,842,2013,10,"-8.6543716,40.6362453",2
2013-11-01,Região de Saúde do Alentejo,"Unidade Local de Saúde do Norte Alentejano, EPE",845,899,1744,2013,11,"-7.4263845,39.3003425",4
2013-11-01,Região de Saúde do Centro,"Centro Hospitalar Universitário Cova da Beira, EPE",189,165,354,2013,11,"-7.4922407,40.2804158",2
2013-11-01,Região de Saúde do Centro,"Centro Hospitalar do Baixo Vouga, EPE",486,460,946,2013,11,"-8.6543716,40.6362453",2
2013-11-01,Região de Saúde do Centro,"Unidade Local de Saúde de Castelo Branco, EPE",96,87,183,2013,11,"-7.4981271,39.8212263",2
2014-01-01,Região de Saúde do Alentejo,"Unidade Local de Saúde do Baixo Alentejo, EPE",0,0,0,2014,1,"-7.8721227,38.014123",4
2014-01-01,Região de Saúde do Algarve,"Centro Hospitalar Universitário do Algarve,EPE",87,10,97,2014,1,"-7.9281554,37.0238973",5
2014-01-01,Região de Saúde do Centro,"Centro Hospitalar e Universitário de Coimbra, EPE",87,71,158,2014,1,"-8.4098211,40.2191523",2
2014-01-01,Região de Saúde LVT,"Centro Hospitalar de Setúbal, EPE",0,0,0,2014,1,"-8.8818638,38.5283754",3
2014-01-01,Região de Saúde Norte,"Unidade Local de Saúde de Matosinhos, EPE",138,0,138,2014,1,"-8.6745115,41.1794456",1
2014-02-01,Região de Saúde do Centro,"Unidade Local de Saúde da Guarda, EPE",49,10,59,2014,2,"-7.2734793,40.5309916",2
2014-02-01,Região de Saúde LVT,"Hospital Professor Doutor Fernando Fonseca, EPE",0,0,0,2014,2,"-9.2264834,38.7422257",3
2014-02-01,Região de Saúde Norte,"Unidade Local de Saúde do Nordeste, EPE",0,0,0,2014,2,"-6.7888197,41.8056532",1
2014-03-01,Região de Saúde do Alentejo,"Unidade Local de Saúde do Baixo Alentejo, EPE",17,8,25,2014,3,"-7.8721227,38.014123",4
2014-03-01,Região de Saúde do Algarve,"Centro Hospitalar Universitário do Algarve,EPE",259,23,282,2014,3,"-7.9281554,37.0238973",5
2014-03-01,Região de Saúde do Centro,"Unidade Local de Saúde da Guarda, EPE",59,12,71,2014,3,"-7.2734793,40.5309916",2
2014-03-01,Região de Saúde LVT,"Centro Hospitalar de Setúbal, EPE",0,0,0,2014,3,"-8.8818638,38.5283754",3
2014-03-01,Região de Saúde Norte,"Centro Hospitalar Universitário do Porto, EPE",100,0,100,2014,3,"-8.6172617,41.1472498",1
2014-04-01,Região de Saúde do Centro,"Centro Hospitalar do Baixo Vouga, EPE",174,185,359,2014,4,"-8.6543716,40.6362453",2
2014-04-01,Região de Saúde do Centro,"Centro Hospitalar e Universitário de Coimbra, EPE",390,254,644,2014,4,"-8.4098211,40.2191523",2
2014-04-01,Região de Saúde Norte,"Centro Hospitalar Universitário do Porto, EPE",127,0,127,2014,4,"-8.6172617,41.1472498",1
2014-04-01,Região de Saúde Norte,"Centro Hospitalar Trás-os-Montes e Alto Douro, EPE",204,0,204,2014,4,"-7.7515252,41.3031784",1
2014-04-01,Região de Saúde Norte,"Unidade Local de Saúde de Matosinhos, EPE",672,0,672,2014,4,"-8.6745115,41.1794456",1
2014-05-01,Região de Saúde do Alentejo,"Unidade Local de Saúde do Norte Alentejano, EPE",294,481,775,2014,5,"-7.4263845,39.3003425",4
2014-05-01,Região de Saúde do Centro,"Centro Hospitalar Universitário Cova da Beira, EPE",131,79,210,2014,5,"-7.4922407,40.2804158",2
2014-05-01,Região de Saúde do Centro,"Unidade Local de Saúde de Castelo Branco, EPE",83,64,147,2014,5,"-7.4981271,39.8212263",2
2014-05-01,Região de Saúde LVT,"Hospital Professor Doutor Fernando Fonseca, EPE",0,0,0,2014,5,"-9.2264834,38.7422257",3
2014-05-01,Região de Saúde Norte,"Centro Hospitalar Trás-os-Montes e Alto Douro, EPE",243,0,243,2014,5,"-7.7515252,41.3031784",1
2014-06-01,Região de Saúde Norte,"Unidade Local de Saúde de Matosinhos, EPE",998,0,998,2014,6,"-8.6745115,41.1794456",1
2014-07-01,Região de Saúde do Alentejo,"Hospital Espírito Santo de Évora, EPE",742,338,1080,2014,7,"-7.9032848,38.5684861",4
2014-07-01,Região de Saúde do Centro,"Centro Hospitalar Universitário Cova da Beira, EPE",187,90,277,2014,7,"-7.4922407,40.2804158",2
2014-07-01,Região de Saúde do Centro,"Unidade Local de Saúde de Castelo Branco, EPE",111,73,184,2014,7,"-7.4981271,39.8212263",2
2014-09-01,Região de Saúde do Centro,"Centro Hospitalar do Baixo Vouga, EPE",394,416,810,2014,9,"-8.6543716,40.6362453",2
2014-09-01,Região de Saúde do Centro,"Unidade Local de Saúde de Castelo Branco, EPE",120,84,204,2014,9,"-7.4981271,39.8212263",2
2014-09-01,Região de Saúde LVT,"Hospital Professor Doutor Fernando Fonseca, EPE",0,0,0,2014,9,"-9.2264834,38.7422257",3
2014-10-01,Região de Saúde do Alentejo,"Unidade Local de Saúde do Norte Alentejano, EPE",581,885,1466,2014,10,"-7.4263845,39.3003425",4
2014-10-01,Região de Saúde do Centro,"Centro Hospitalar Universitário Cova da Beira, EPE",239,124,363,2014,10,"-7.4922407,40.2804158",2
2014-10-01,Região de Saúde do Centro,"Centro Hospitalar do Baixo Vouga, EPE",433,465,898,2014,10,"-8.6543716,40.6362453",2
2014-10-01,Região de Saúde do Centro,"Unidade Local de Saúde da Guarda, EPE",173,39,212,2014,10,"-7.2734793,40.5309916",2
2014-10-01,Região de Saúde do Centro,"Unidade Local de Saúde de Castelo Branco, EPE",127,103,230,2014,10,"-7.4981271,39.8212263",2
2014-10-01,Região de Saúde LVT,"Centro Hospitalar do Oeste, EPE",2,15,17,2014,10,"-9.1258493,39.4054629",3
2014-11-01,Região de Saúde do Alentejo,"Hospital Espírito Santo de Évora, EPE",1083,489,1572,2014,11,"-7.9032848,38.5684861",4
2014-11-01,Região de Saúde do Centro,"Centro Hospitalar do Baixo Vouga, EPE",472,506,978,2014,11,"-8.6543716,40.6362453",2
2014-11-01,Região de Saúde Norte,"Centro Hospitalar Universitário do Porto, EPE",340,0,340,2014,11,"-8.6172617,41.1472498",1
2015-01-01,Região de Saúde Norte,"Centro Hospitalar Trás-os-Montes e Alto Douro, EPE",42,0,42,2015,1,"-7.7515252,41.3031784",1
2015-02-01,Região de Saúde LVT,"Hospital Professor Doutor Fernando Fonseca, EPE",0,0,0,2015,2,"-9.2264834,38.7422257",3
2015-03-01,Região de Saúde do Alentejo,"Unidade Local de Saúde do Norte Alentejano, EPE",173,198,371,2015,3,"-7.4263845,39.3003425",4
2015-03-01,Região de Saúde do Centro,"Unidade Local de Saúde de Castelo Branco, EPE",45,26,71,2015,3,"-7.4981271,39.8212263",2
2015-03-01,Região de Saúde Norte,"Centro Hospitalar Trás-os-Montes e Alto Douro, EPE",127,0,127,2015,3,"-7.7515252,41.3031784",1
2015-04-01,Região de Saúde do Centro,"Centro Hospitalar e Universitário de Coimbra, EPE",532,421,953,2015,4,"-8.4098211,40.2191523",2
2015-04-01,Região de Saúde do Centro,"Unidade Local de Saúde da Guarda, EPE",6,0,6,2015,4,"-7.2734793,40.5309916",2
2015-05-01,Região de Saúde do Alentejo,"Unidade Local de Saúde do Norte Alentejano, EPE",402,370,772,2015,5,"-7.4263845,39.3003425",4
2015-05-01,Região de Saúde do Centro,"Unidade Local de Saúde da Guarda, EPE",14,0,14,2015,5,"-7.2734793,40.5309916",2
2015-05-01,Região de Saúde do Centro,"Unidade Local de Saúde de Castelo Branco, EPE",64,56,120,2015,5,"-7.4981271,39.8212263",2
2015-05-01,Região de Saúde LVT,"Hospital Professor Doutor Fernando Fonseca, EPE",0,0,0,2015,5,"-9.2264834,38.7422257",3
2015-06-01,Região de Saúde do Alentejo,"Hospital Espírito Santo de Évora, EPE",636,320,956,2015,6,"-7.9032848,38.5684861",4
2015-06-01,Região de Saúde do Alentejo,"Unidade Local de Saúde do Baixo Alentejo, EPE",43,30,73,2015,6,"-7.8721227,38.014123",4
2015-06-01,Região de Saúde Norte,"Centro Hospitalar Universitário do Porto, EPE",200,0,200,2015,6,"-8.6172617,41.1472498",1
2015-06-01,Região de Saúde Norte,"Unidade Local de Saúde de Matosinhos, EPE",850,0,850,2015,6,"-8.6745115,41.1794456",1
2015-07-01,Região de Saúde do Alentejo,"Hospital Espírito Santo de Évora, EPE",732,342,1074,2015,7,"-7.9032848,38.5684861",4
2015-07-01,Região de Saúde do Alentejo,"Unidade Local de Saúde do Litoral Alentejano, EPE",0,0,0,2015,7,"-8.6956768,38.0162314",4
2015-07-01,Região de Saúde do Alentejo,"Unidade Local de Saúde do Norte Alentejano, EPE",548,519,1067,2015,7,"-7.4263845,39.3003425",4
2015-07-01,Região de Saúde do Centro,"Unidade Local de Saúde da Guarda, EPE",55,0,55,2015,7,"-7.2734793,40.5309916",2
2015-07-01,Região de Saúde Norte,"Centro Hospitalar Trás-os-Montes e Alto Douro, EPE",185,0,185,2015,7,"-7.7515252,41.3031784",1
2015-08-01,Região de Saúde do Alentejo,"Unidade Local de Saúde do Baixo Alentejo, EPE",55,31,86,2015,8,"-7.8721227,38.014123",4
2015-08-01,Região de Saúde do Alentejo,"Unidade Local de Saúde do Norte Alentejano, EPE",576,560,1136,2015,8,"-7.4263845,39.3003425",4
2015-08-01,Região de Saúde do Centro,"Unidade Local de Saúde da Guarda, EPE",56,0,56,2015,8,"-7.2734793,40.5309916",2
2015-08-01,Região de Saúde LVT,"Centro Hospitalar de Setúbal, EPE",0,0,0,2015,8,"-8.8818638,38.5283754",3
2015-09-01,Região de Saúde do Alentejo,"Hospital Espírito Santo de Évora, EPE",882,390,1272,2015,9,"-7.9032848,38.5684861",4
2015-09-01,Região de Saúde do Centro,"Centro Hospitalar Universitário Cova da Beira, EPE",220,101,321,2015,9,"-7.4922407,40.2804158",2
2015-09-01,Região de Saúde do Centro,"Unidade Local de Saúde da Guarda, EPE",94,0,94,2015,9,"-7.2734793,40.5309916",2
2015-09-01,Região de Saúde Norte,"Unidade Local de Saúde de Matosinhos, EPE",1488,0,1488,2015,9,"-8.6745115,41.1794456",1
2015-10-01,Região de Saúde do Centro,"Centro Hospitalar do Baixo Vouga, EPE",429,497,926,2015,10,"-8.6543716,40.6362453",2
2015-10-01,Região de Saúde do Centro,"Centro Hospitalar e Universitário de Coimbra, EPE",1863,1327,3190,2015,10,"-8.4098211,40.2191523",2
2015-10-01,Região de Saúde do Centro,"Unidade Local de Saúde da Guarda, EPE",122,0,122,2015,10,"-7.2734793,40.5309916",2
2015-10-01,Região de Saúde LVT,"Centro Hospitalar de Setúbal, EPE",0,0,0,2015,10,"-8.8818638,38.5283754",3
2015-10-01,Região de Saúde Norte,"Unidade Local de Saúde de Matosinhos, EPE",1695,0,1695,2015,10,"-8.6745115,41.1794456",1
2015-11-01,Região de Saúde do Centro,"Centro Hospitalar Tondela-Viseu, EPE",295,245,540,2015,11,"-8.0827433,40.516364",2
2015-11-01,Região de Saúde Norte,"Centro Hospitalar Universitário do Porto, EPE",374,0,374,2015,11,"-8.6172617,41.1472498",1
2015-11-01,Região de Saúde Norte,"Centro Hospitalar Trás-os-Montes e Alto Douro, EPE",337,0,337,2015,11,"-7.7515252,41.3031784",1
2015-12-01,Região de Saúde do Alentejo,"Unidade Local de Saúde do Baixo Alentejo, EPE",73,45,118,2015,12,"-7.8721227,38.014123",4
2015-12-01,Região de Saúde do Algarve,"Centro Hospitalar Universitário do Algarve,EPE",1270,121,1391,2015,12,"-7.9281554,37.0238973",5
2015-12-01,Região de Saúde do Centro,"Unidade Local de Saúde de Castelo Branco, EPE",142,133,275,2015,12,"-7.4981271,39.8212263",2
2016-01-01,Região de Saúde do Centro,"Centro Hospitalar Tondela-Viseu, EPE",26,14,40,2016,1,"-8.0827433,40.516364",2
2016-02-01,Região de Saúde do Alentejo,"Hospital Espírito Santo de Évora, EPE",179,43,222,2016,2,"-7.9032848,38.5684861",4
2016-02-01,Região de Saúde do Algarve,"Centro Hospitalar Universitário do Algarve,EPE",291,25,316,2016,2,"-7.9281554,37.0238973",5
2016-02-01,Região de Saúde do Centro,"Centro Hospitalar e Universitário de Coimbra, EPE",476,258,734,2016,2,"-8.4098211,40.2191523",2
2016-02-01,Região de Saúde Norte,"Unidade Local de Saúde de Matosinhos, EPE",352,0,352,2016,2,"-8.6745115,41.1794456",1
2016-03-01,Região de Saúde do Centro,"Centro Hospitalar Universitário Cova da Beira, EPE",54,38,92,2016,3,"-7.4922407,40.2804158",2
2016-03-01,Região de Saúde do Centro,"Unidade Local de Saúde da Guarda, EPE",112,0,112,2016,3,"-7.2734793,40.5309916",2
2016-03-01,Região de Saúde LVT,"Centro Hospitalar de Setúbal, EPE",0,0,0,2016,3,"-8.8818638,38.5283754",3
2016-05-01,Região de Saúde do Alentejo,"Hospital Espírito Santo de Évora, EPE",519,136,655,2016,5,"-7.9032848,38.5684861",4
2016-05-01,Região de Saúde LVT,"Centro Hospitalar de Setúbal, EPE",0,0,0,2016,5,"-8.8818638,38.5283754",3
2016-05-01,Região de Saúde Norte,"Centro Hospitalar Universitário de São João, EPE",0,0,0,2016,5,"-8.6010558,41.1831056",1
2016-05-01,Região de Saúde Norte,"Centro Hospitalar Universitário do Porto, EPE",270,0,270,2016,5,"-8.6172617,41.1472498",1
2016-06-01,Região de Saúde do Algarve,"Centro Hospitalar Universitário do Algarve,EPE",879,73,952,2016,6,"-7.9281554,37.0238973",5
2016-06-01,Região de Saúde Norte,"Centro Hospitalar Trás-os-Montes e Alto Douro, EPE",289,0,289,2016,6,"-7.7515252,41.3031784",1
2016-07-01,Região de Saúde do Alentejo,"Hospital Espírito Santo de Évora, EPE",663,177,840,2016,7,"-7.9032848,38.5684861",4
2016-07-01,Região de Saúde do Alentejo,"Unidade Local de Saúde do Baixo Alentejo, EPE",14,9,23,2016,7,"-7.8721227,38.014123",4
2016-07-01,Região de Saúde do Centro,Centro Medicina de Reabilitação da Região Centro Rovisco Pais,10,1,11,2016,7,"-8.7707806,40.297919",2
2016-07-01,Região de Saúde do Centro,"Unidade Local de Saúde da Guarda, EPE",245,0,245,2016,7,"-7.2734793,40.5309916",2
2016-07-01,Região de Saúde LVT,"Centro Hospitalar de Setúbal, EPE",0,0,0,2016,7,"-8.8818638,38.5283754",3
2016-07-01,Região de Saúde Norte,"Centro Hospitalar Universitário de São João, EPE",0,0,0,2016,7,"-8.6010558,41.1831056",1
2016-08-01,Região de Saúde do Alentejo,"Hospital Espírito Santo de Évora, EPE",747,216,963,2016,8,"-7.9032848,38.5684861",4
2016-08-01,Região de Saúde do Centro,"Centro Hospitalar Universitário Cova da Beira, EPE",120,102,222,2016,8,"-7.4922407,40.2804158",2
2016-08-01,Região de Saúde do Centro,"Centro Hospitalar e Universitário de Coimbra, EPE",1796,865,2661,2016,8,"-8.4098211,40.2191523",2
2016-08-01,Região de Saúde LVT,"Centro Hospitalar de Setúbal, EPE",12,0,12,2016,8,"-8.8818638,38.5283754",3
2016-08-01,Região de Saúde LVT,"Instituto Português Oncologia de Lisboa, EPE",1,0,1,2016,8,"-9.1634516,38.7396768",3
2016-08-01,Região de Saúde Norte,"Centro Hospitalar Universitário do Porto, EPE",579,0,579,2016,8,"-8.6172617,41.1472498",1
2016-09-01,Região de Saúde do Centro,"Centro Hospitalar do Baixo Vouga, EPE",406,387,793,2016,9,"-8.6543716,40.6362453",2
2016-09-01,Região de Saúde do Centro,"Centro Hospitalar e Universitário de Coimbra, EPE",1993,983,2976,2016,9,"-8.4098211,40.2191523",2
2016-09-01,Região de Saúde do Centro,"Centro Hospitalar Tondela-Viseu, EPE",192,141,333,2016,9,"-8.0827433,40.516364",2
2016-09-01,Região de Saúde do Centro,"Unidade Local de Saúde da Guarda, EPE",284,0,284,2016,9,"-7.2734793,40.5309916",2
2016-09-01,Região de Saúde Norte,"Centro Hospitalar Universitário do Porto, EPE",676,0,676,2016,9,"-8.6172617,41.1472498",1
2016-10-01,Região de Saúde do Alentejo,"Hospital Espírito Santo de Évora, EPE",883,269,1152,2016,10,"-7.9032848,38.5684861",4
2016-10-01,Região de Saúde do Algarve,"Centro Hospitalar Universitário do Algarve,EPE",1402,111,1513,2016,10,"-7.9281554,37.0238973",5
2016-10-01,Região de Saúde do Centro,"Centro Hospitalar Tondela-Viseu, EPE",228,178,406,2016,10,"-8.0827433,40.516364",2
2016-10-01,Região de Saúde LVT,"Instituto Português Oncologia de Lisboa, EPE",2,0,2,2016,10,"-9.1634516,38.7396768",3
2016-11-01,Região de Saúde do Alentejo,"Unidade Local de Saúde do Norte Alentejano, EPE",473,613,1086,2016,11,"-7.4263845,39.3003425",4
2016-11-01,Região de Saúde LVT,"Centro Hospitalar de Setúbal, EPE",69,0,69,2016,11,"-8.8818638,38.5283754",3
2016-11-01,Região de Saúde Norte,"Centro Hospitalar Universitário do Porto, EPE",825,0,825,2016,11,"-8.6172617,41.1472498",1
2016-12-01,Região de Saúde do Alentejo,"Unidade Local de Saúde do Norte Alentejano, EPE",512,647,1159,2016,12,"-7.4263845,39.3003425",4
2016-12-01,Região de Saúde do Centro,"Centro Hospitalar Tondela-Viseu, EPE",266,188,454,2016,12,"-8.0827433,40.516364",2
2016-12-01,Região de Saúde Norte,"Centro Hospitalar Universitário do Porto, EPE",878,0,878,2016,12,"-8.6172617,41.1472498",1
2016-12-01,Região de Saúde Norte,"Unidade Local de Saúde de Matosinhos, EPE",2110,0,2110,2016,12,"-8.6745115,41.1794456",1
2017-01-01,Região de Saúde do Centro,"Centro Hospitalar Universitário Cova da Beira, EPE",12,12,24,2017,1,"-7.4922407,40.2804158",2
2017-01-01,Região de Saúde do Centro,"Centro Hospitalar do Baixo Vouga, EPE",28,61,89,2017,1,"-8.6543716,40.6362453",2
2017-01-01,Região de Saúde Norte,"Centro Hospitalar Universitário do Porto, EPE",94,0,94,2017,1,"-8.6172617,41.1472498",1
2017-02-01,Região de Saúde do Alentejo,"Unidade Local de Saúde do Norte Alentejano, EPE",102,80,182,2017,2,"-7.4263845,39.3003425",4
2017-02-01,Região de Saúde do Centro,"Centro Hospitalar Universitário Cova da Beira, EPE",34,22,56,2017,2,"-7.4922407,40.2804158",2
2017-02-01,Região de Saúde do Centro,"Centro Hospitalar Tondela-Viseu, EPE",27,14,41,2017,2,"-8.0827433,40.516364",2
2017-02-01,Região de Saúde LVT,"Centro Hospitalar Universitário Lisboa Central, EPE",3,6,9,2017,2,"-9.1371248,38.7166948",3
2017-02-01,Região de Saúde Norte,"Unidade Local de Saúde de Matosinhos, EPE",374,2227,2601,2017,2,"-8.6745115,41.1794456",1
2017-03-01,Região de Saúde do Alentejo,"Unidade Local de Saúde do Baixo Alentejo, EPE",0,0,0,2017,3,"-7.8721227,38.014123",4
2017-03-01,Região de Saúde do Centro,Centro Medicina de Reabilitação da Região Centro Rovisco Pais,14,1,15,2017,3,"-8.7707806,40.297919",2
2017-03-01,Região de Saúde do Centro,"Unidade Local de Saúde da Guarda, EPE",76,0,76,2017,3,"-7.2734793,40.5309916",2
2017-03-01,Região de Saúde do Centro,"Unidade Local de Saúde de Castelo Branco, EPE",94,12,106,2017,3,"-7.4981271,39.8212263",2
2017-04-01,Região de Saúde do Algarve,"Centro Hospitalar Universitário do Algarve,EPE",205,4,209,2017,4,"-7.9281554,37.0238973",5
2017-04-01,Região de Saúde do Centro,"Unidade Local de Saúde da Guarda, EPE",108,0,108,2017,4,"-7.2734793,40.5309916",2
2017-04-01,Região de Saúde Norte,"Centro Hospitalar Universitário do Porto, EPE",453,0,453,2017,4,"-8.6172617,41.1472498",1
2017-05-01,Região de Saúde do Alentejo,"Unidade Local de Saúde do Litoral Alentejano, EPE",10,3,13,2017,5,"-8.6956768,38.0162314",4
2017-05-01,Região de Saúde do Algarve,"Centro Hospitalar Universitário do Algarve,EPE",224,4,228,2017,5,"-7.9281554,37.0238973",5
2017-05-01,Região de Saúde do Centro,"Centro Hospitalar do Baixo Vouga, EPE",226,235,461,2017,5,"-8.6543716,40.6362453",2
2017-05-01,Região de Saúde LVT,"Hospital Garcia de Orta, EPE",71,0,71,2017,5,"-9.1822554,38.6658713",3
2017-05-01,Região de Saúde Norte,"Unidade Local de Saúde de Matosinhos, EPE",929,5626,6555,2017,5,"-8.6745115,41.1794456",1
2017-06-01,Região de Saúde do Alentejo,"Unidade Local de Saúde do Litoral Alentejano, EPE",10,8,18,2017,6,"-8.6956768,38.0162314",4
2017-06-01,Região de Saúde do Alentejo,"Unidade Local de Saúde do Norte Alentejano, EPE",369,300,669,2017,6,"-7.4263845,39.3003425",4
2017-06-01,Região de Saúde do Centro,Centro Medicina de Reabilitação da Região Centro Rovisco Pais,21,1,22,2017,6,"-8.7707806,40.297919",2
2017-06-01,Região de Saúde do Centro,"Unidade Local de Saúde de Castelo Branco, EPE",184,55,239,2017,6,"-7.4981271,39.8212263",2
2017-07-01,Região de Saúde do Alentejo,"Unidade Local de Saúde do Norte Alentejano, EPE",428,342,770,2017,7,"-7.4263845,39.3003425",4
2017-07-01,Região de Saúde do Centro,"Unidade Local de Saúde de Castelo Branco, EPE",202,67,269,2017,7,"-7.4981271,39.8212263",2
2017-08-01,Região de Saúde do Algarve,"Centro Hospitalar Universitário do Algarve,EPE",386,5,391,2017,8,"-7.9281554,37.0238973",5
2017-08-01,Região de Saúde Norte,"Unidade Local de Saúde do Nordeste, EPE",2,0,2,2017,8,"-6.7888197,41.8056532",1
2017-09-01,Região de Saúde Norte,"Centro Hospitalar Universitário do Porto, EPE",1226,0,1226,2017,9,"-8.6172617,41.1472498",1
2017-09-01,Região de Saúde Norte,"Unidade Local de Saúde de Matosinhos, EPE",1921,10091,12012,2017,9,"-8.6745115,41.1794456",1
2017-10-01,Região de Saúde do Alentejo,"Unidade Local de Saúde do Norte Alentejano, EPE",558,547,1105,2017,10,"-7.4263845,39.3003425",4
2017-10-01,Região de Saúde do Centro,"Centro Hospitalar Universitário Cova da Beira, EPE",177,79,256,2017,10,"-7.4922407,40.2804158",2
2017-10-01,Região de Saúde do Centro,"Centro Hospitalar do Baixo Vouga, EPE",454,434,888,2017,10,"-8.6543716,40.6362453",2
2017-10-01,Região de Saúde do Centro,"Unidade Local de Saúde de Castelo Branco, EPE",266,113,379,2017,10,"-7.4981271,39.8212263",2
2017-10-01,Região de Saúde Norte,"Centro Hospitalar Trás-os-Montes e Alto Douro, EPE",413,1,414,2017,10,"-7.7515252,41.3031784",1
2017-11-01,Região de Saúde do Alentejo,"Hospital Espírito Santo de Évora, EPE",799,288,1087,2017,11,"-7.9032848,38.5684861",4
2017-11-01,Região de Saúde do Algarve,"Centro Hospitalar Universitário do Algarve,EPE",502,5,507,2017,11,"-7.9281554,37.0238973",5
2017-11-01,Região de Saúde do Centro,"Centro Hospitalar Universitário Cova da Beira, EPE",192,86,278,2017,11,"-7.4922407,40.2804158",2
2017-11-01,Região de Saúde do Centro,"Centro Hospitalar e Universitário de Coimbra, EPE",2236,1053,3289,2017,11,"-8.4098211,40.2191523",2
2017-11-01,Região de Saúde Norte,"Centro Hospitalar Universitário do Porto, EPE",1571,0,1571,2017,11,"-8.6172617,41.1472498",1
2017-11-01,Região de Saúde Norte,"Centro Hospitalar Trás-os-Montes e Alto Douro, EPE",478,1,479,2017,11,"-7.7515252,41.3031784",1
2017-12-01,Região de Saúde do Centro,"Centro Hospitalar de Leiria, EPE",377,256,633,2017,12,"-8.7982706,39.7414812",2
2017-12-01,Região de Saúde do Centro,Centro Medicina de Reabilitação da Região Centro Rovisco Pais,31,1,32,2017,12,"-8.7707806,40.297919",2
2017-12-01,Região de Saúde LVT,"Centro Hospitalar Universitário de Lisboa Norte, EPE",0,0,0,2017,12,"-9.1616116,38.7500861",3
2017-12-01,Região de Saúde LVT,"Hospital Garcia de Orta, EPE",287,0,287,2017,12,"-9.1822554,38.6658713",3
2018-01-01,Região de Saúde do Alentejo,"Unidade Local de Saúde do Norte Alentejano, EPE",59,63,122,2018,1,"-7.4263845,39.3003425",4
2018-01-01,Região de Saúde do Centro,Centro Medicina de Reabilitação da Região Centro Rovisco Pais,3,0,3,2018,1,"-8.7707806,40.297919",2
2018-01-01,Região de Saúde LVT,"Centro Hospitalar Universitário Lisboa Central, EPE",0,0,0,2018,1,"-9.1371248,38.7166948",3
2018-01-01,Região de Saúde Norte,"Centro Hospitalar Trás-os-Montes e Alto Douro, EPE",60,0,60,2018,1,"-7.7515252,41.3031784",1
2018-02-01,Região de Saúde do Algarve,"Centro Hospitalar Universitário do Algarve,EPE",2,2,4,2018,2,"-7.9281554,37.0238973",5
2018-02-01,Região de Saúde LVT,"Centro Hospitalar de Lisboa Ocidental, EPE",16,0,16,2018,2,"-9.216985,38.708454",3
2018-02-01,Região de Saúde Norte,"Instituto Português Oncologia do Porto, EPE",22,7,29,2018,2,"-8.6062881,41.1785642",1
2018-03-01,Região de Saúde do Alentejo,"Hospital Espírito Santo de Évora, EPE",232,122,354,2018,3,"-7.9032848,38.5684861",4
2018-03-01,Região de Saúde do Centro,"Centro Hospitalar de Leiria, EPE",105,70,175,2018,3,"-8.7982706,39.7414812",2
2018-03-01,Região de Saúde do Centro,"Centro Hospitalar Tondela-Viseu, EPE",4,7,11,2018,3,"-8.0827433,40.516364",2
2018-03-01,Região de Saúde LVT,"Centro Hospitalar de Lisboa Ocidental, EPE",25,0,25,2018,3,"-9.216985,38.708454",3
2018-03-01,Região de Saúde LVT,"Hospital Professor Doutor Fernando Fonseca, EPE",0,0,0,2018,3,"-9.2264834,38.7422257",3
2018-04-01,Região de Saúde do Centro,"Centro Hospitalar de Leiria, EPE",136,89,225,2018,4,"-8.7982706,39.7414812",2
2018-05-01,Região de Saúde do Centro,"Centro Hospitalar do Baixo Vouga, EPE",136,160,296,2018,5,"-8.6543716,40.6362453",2
2018-05-01,Região de Saúde do Centro,Centro Medicina de Reabilitação da Região Centro Rovisco Pais,13,2,15,2018,5,"-8.7707806,40.297919",2
2018-05-01,Região de Saúde LVT,"Hospital Garcia de Orta, EPE",239,0,239,2018,5,"-9.1822554,38.6658713",3
2018-05-01,Região de Saúde Norte,"Centro Hospitalar Trás-os-Montes e Alto Douro, EPE",125,0,125,2018,5,"-7.7515252,41.3031784",1
2018-06-01,Região de Saúde do Alentejo,"Unidade Local de Saúde do Norte Alentejano, EPE",326,309,635,2018,6,"-7.4263845,39.3003425",4
2018-06-01,Região de Saúde do Algarve,"Centro Hospitalar Universitário do Algarve,EPE",8,3,11,2018,6,"-7.9281554,37.0238973",5
2018-06-01,Região de Saúde do Centro,"Centro Hospitalar e Universitário de Coimbra, EPE",928,402,1330,2018,6,"-8.4098211,40.2191523",2
2018-06-01,Região de Saúde LVT,"Centro Hospitalar de Lisboa Ocidental, EPE",55,0,55,2018,6,"-9.216985,38.708454",3
2018-07-01,Região de Saúde do Alentejo,"Hospital Espírito Santo de Évora, EPE",532,218,750,2018,7,"-7.9032848,38.5684861",4
2018-07-01,Região de Saúde do Alentejo,"Unidade Local de Saúde do Baixo Alentejo, EPE",25,0,25,2018,7,"-7.8721227,38.014123",4
2018-07-01,Região de Saúde do Centro,Hospital Arcebispo João Crisóstomo,11,0,11,2018,7,"-8.5933462,40.3470015",2
2018-07-01,Região de Saúde do Centro,"Unidade Local de Saúde de Castelo Branco, EPE",154,94,248,2018,7,"-7.4981271,39.8212263",2
2018-07-01,Região de Saúde LVT,"Centro Hospitalar Universitário Lisboa Central, EPE",23,21,44,2018,7,"-9.1371248,38.7166948",3
2018-07-01,Região de Saúde Norte,"Centro Hospitalar Trás-os-Montes e Alto Douro, EPE",166,0,166,2018,7,"-7.7515252,41.3031784",1
2018-07-01,Região de Saúde Norte,"Unidade Local de Saúde de Matosinhos, EPE",0,7536,7536,2018,7,"-8.6745115,41.1794456",1
2018-08-01,Região de Saúde do Alentejo,"Hospital Espírito Santo de Évora, EPE",596,240,836,2018,8,"-7.9032848,38.5684861",4
2018-08-01,Região de Saúde do Centro,"Centro Hospitalar Universitário Cova da Beira, EPE",308,112,420,2018,8,"-7.4922407,40.2804158",2
2018-08-01,Região de Saúde do Centro,"Centro Hospitalar do Baixo Vouga, EPE",264,248,512,2018,8,"-8.6543716,40.6362453",2
2018-08-01,Região de Saúde Norte,"Unidade Local de Saúde de Matosinhos, EPE",0,8570,8570,2018,8,"-8.6745115,41.1794456",1
2018-09-01,Região de Saúde do Alentejo,"Unidade Local de Saúde do Litoral Alentejano, EPE",17,24,41,2018,9,"-8.6956768,38.0162314",4
2018-09-01,Região de Saúde do Alentejo,"Unidade Local de Saúde do Norte Alentejano, EPE",513,382,895,2018,9,"-7.4263845,39.3003425",4
2018-09-01,Região de Saúde do Centro,"Centro Hospitalar Universitário Cova da Beira, EPE",329,123,452,2018,9,"-7.4922407,40.2804158",2
2018-09-01,Região de Saúde do Centro,"Centro Hospitalar e Universitário de Coimbra, EPE",1541,751,2292,2018,9,"-8.4098211,40.2191523",2
2018-09-01,Região de Saúde do Centro,Hospital Arcebispo João Crisóstomo,12,0,12,2018,9,"-8.5933462,40.3470015",2
2018-09-01,Região de Saúde LVT,"Centro Hospitalar de Lisboa Ocidental, EPE",90,0,90,2018,9,"-9.216985,38.708454",3
2018-09-01,Região de Saúde Norte,"Centro Hospitalar Universitário do Porto, EPE",1855,0,1855,2018,9,"-8.6172617,41.1472498",1
2018-10-01,Região de Saúde do Centro,Hospital Arcebispo João Crisóstomo,19,0,19,2018,10,"-8.5933462,40.3470015",2
2018-10-01,Região de Saúde Norte,"Unidade Local de Saúde do Nordeste, EPE",0,1,1,2018,10,"-6.7888197,41.8056532",1
2018-11-01,Região de Saúde do Algarve,"Centro Hospitalar Universitário do Algarve,EPE",17,7,24,2018,11,"-7.9281554,37.0238973",5
2018-11-01,Região de Saúde do Centro,"Centro Hospitalar de Leiria, EPE",303,238,541,2018,11,"-8.7982706,39.7414812",2
2018-11-01,Região de Saúde Norte,"Unidade Local de Saúde de Matosinhos, EPE",0,11555,11555,2018,11,"-8.6745115,41.1794456",1
2018-12-01,Região de Saúde do Centro,Hospital Arcebispo João Crisóstomo,37,0,37,2018,12,"-8.5933462,40.3470015",2
2018-12-01,Região de Saúde Norte,"Centro Hospitalar Trás-os-Montes e Alto Douro, EPE",570,0,570,2018,12,"-7.7515252,41.3031784",1
2019-01-01,Região de Saúde do Algarve,"Centro Hospitalar Universitário do Algarve,EPE",0,0,0,2019,1,"-7.9281554,37.0238973",5
2019-01-01,Região de Saúde do Centro,"Centro Hospitalar Universitário Cova da Beira, EPE",67,9,76,2019,1,"-7.4922407,40.2804158",2
2019-01-01,Região de Saúde do Centro,"Centro Hospitalar do Baixo Vouga, EPE",44,60,104,2019,1,"-8.6543716,40.6362453",2
2019-01-01,Região de Saúde LVT,"Centro Hospitalar de Lisboa Ocidental, EPE",29,0,29,2019,1,"-9.216985,38.708454",3
2019-02-01,Região de Saúde do Alentejo,"Hospital Espírito Santo de Évora, EPE",221,67,288,2019,2,"-7.9032848,38.5684861",4
2019-02-01,Região de Saúde do Centro,"Centro Hospitalar do Baixo Vouga, EPE",92,88,180,2019,2,"-8.6543716,40.6362453",2
2019-02-01,Região de Saúde do Centro,"Centro Hospitalar Tondela-Viseu, EPE",38,20,58,2019,2,"-8.0827433,40.516364",2
2019-02-01,Região de Saúde do Centro,Centro Medicina de Reabilitação da Região Centro Rovisco Pais,5,0,5,2019,2,"-8.7707806,40.297919",2
2019-02-01,Região de Saúde LVT,"Centro Hospitalar de Lisboa Ocidental, EPE",42,0,42,2019,2,"-9.216985,38.708454",3
2019-02-01,Região de Saúde LVT,"Centro Hospitalar Universitário de Lisboa Norte, EPE",296,5,301,2019,2,"-9.1616116,38.7500861",3
2019-02-01,Região de Saúde Norte,"Centro Hospitalar Trás-os-Montes e Alto Douro, EPE",219,0,219,2019,2,"-7.7515252,41.3031784",1
2019-03-01,Região de Saúde do Alentejo,"Unidade Local de Saúde do Baixo Alentejo, EPE",15,22,37,2019,3,"-7.8721227,38.014123",4
2019-03-01,Região de Saúde do Centro,Centro Medicina de Reabilitação da Região Centro Rovisco Pais,5,0,5,2019,3,"-8.7707806,40.297919",2
2019-03-01,Região de Saúde do Centro,"Unidade Local de Saúde de Castelo Branco, EPE",90,24,114,2019,3,"-7.4981271,39.8212263",2
2019-03-01,Região de Saúde LVT,"Centro Hospitalar Médio Tejo, EPE",2,1,3,2019,3,"-8.5404429,39.478072",3
2019-04-01,Região de Saúde LVT,"Centro Hospitalar Universitário Lisboa Central, EPE",11,11,22,2019,4,"-9.1371248,38.7166948",3
2019-04-01,Região de Saúde LVT,"Centro Hospitalar de Lisboa Ocidental, EPE",74,0,74,2019,4,"-9.216985,38.708454",3
2019-04-01,Região de Saúde Norte,"Centro Hospitalar Trás-os-Montes e Alto Douro, EPE",446,0,446,2019,4,"-7.7515252,41.3031784",1
2019-05-01,Região de Saúde do Algarve,"Centro Hospitalar Universitário do Algarve,EPE",0,0,0,2019,5,"-7.9281554,37.0238973",5
2019-05-01,Região de Saúde LVT,"Centro Hospitalar Universitário Lisboa Central, EPE",15,12,27,2019,5,"-9.1371248,38.7166948",3
2019-06-01,Região de Saúde do Algarve,"Centro Hospitalar Universitário do Algarve,EPE",0,0,0,2019,6,"-7.9281554,37.0238973",5
2019-06-01,Região de Saúde do Centro,"Centro Hospitalar e Universitário de Coimbra, EPE",1345,459,1804,2019,6,"-8.4098211,40.2191523",2
2019-06-01,Região de Saúde LVT,"Centro Hospitalar Médio Tejo, EPE",3,3,6,2019,6,"-8.5404429,39.478072",3
2019-06-01,Região de Saúde Norte,"Centro Hospitalar Universitário do Porto, EPE",1151,0,1151,2019,6,"-8.6172617,41.1472498",1
2019-07-01,Região de Saúde do Algarve,"Centro Hospitalar Universitário do Algarve,EPE",0,0,0,2019,7,"-7.9281554,37.0238973",5
2019-07-01,Região de Saúde do Centro,"Centro Hospitalar Universitário Cova da Beira, EPE",285,53,338,2019,7,"-7.4922407,40.2804158",2
2019-07-01,Região de Saúde do Centro,"Centro Hospitalar do Baixo Vouga, EPE",389,277,666,2019,7,"-8.6543716,40.6362453",2
2019-07-01,Região de Saúde do Centro,"Centro Hospitalar e Universitário de Coimbra, EPE",1638,527,2165,2019,7,"-8.4098211,40.2191523",2
2019-07-01,Região de Saúde do Centro,Centro Medicina de Reabilitação da Região Centro Rovisco Pais,5,0,5,2019,7,"-8.7707806,40.297919",2
2019-07-01,Região de Saúde LVT,"Centro Hospitalar Universitário Lisboa Central, EPE",22,21,43,2019,7,"-9.1371248,38.7166948",3
2019-07-01,Região de Saúde Norte,"Unidade Local de Saúde de Matosinhos, EPE",0,6959,6959,2019,7,"-8.6745115,41.1794456",1
2019-08-01,Região de Saúde do Alentejo,"Unidade Local de Saúde do Baixo Alentejo, EPE",28,33,61,2019,8,"-7.8721227,38.014123",4
2019-08-01,Região de Saúde LVT,"Centro Hospitalar de Lisboa Ocidental, EPE",162,0,162,2019,8,"-9.216985,38.708454",3
2019-08-01,Região de Saúde Norte,"Centro Hospitalar Trás-os-Montes e Alto Douro, EPE",772,0,772,2019,8,"-7.7515252,41.3031784",1
2019-09-01,Região de Saúde do Centro,"Unidade Local de Saúde de Castelo Branco, EPE",204,103,307,2019,9,"-7.4981271,39.8212263",2
2019-09-01,Região de Saúde LVT,"Centro Hospitalar Universitário de Lisboa Norte, EPE",2537,29,2566,2019,9,"-9.1616116,38.7500861",3
2019-09-01,Região de Saúde LVT,"Centro Hospitalar Médio Tejo, EPE",11,7,18,2019,9,"-8.5404429,39.478072",3
2019-09-01,Região de Saúde LVT,"Hospital Garcia de Orta, EPE",0,0,0,2019,9,"-9.1822554,38.6658713",3
2019-09-01,Região de Saúde Norte,"Hospital de Braga, EPE",367,0,367,2019,9,"-8.398982,41.56785",1
2019-10-01,Região de Saúde LVT,"Centro Hospitalar de Setúbal, EPE",0,0,0,2019,10,"-8.8818638,38.5283754",3
2019-10-01,Região de Saúde Norte,"Centro Hospitalar Universitário de São João, EPE",0,0,0,2019,10,"-8.6010558,41.1831056",1
2019-11-01,Região de Saúde do Centro,"Centro Hospitalar e Universitário de Coimbra, EPE",2539,836,3375,2019,11,"-8.4098211,40.2191523",2
2019-11-01,Região de Saúde do Centro,"Centro Hospitalar Tondela-Viseu, EPE",239,69,308,2019,11,"-8.0827433,40.516364",2
2019-11-01,Região de Saúde do Centro,"Unidade Local de Saúde de Castelo Branco, EPE",248,129,377,2019,11,"-7.4981271,39.8212263",2
2019-11-01,Região de Saúde LVT,"Centro Hospitalar de Lisboa Ocidental, EPE",275,0,275,2019,11,"-9.216985,38.708454",3
2019-12-01,Região de Saúde do Alentejo,"Unidade Local de Saúde do Litoral Alentejano, EPE",13,18,31,2019,12,"-8.6956768,38.0162314",4
2019-12-01,Região de Saúde do Alentejo,"Unidade Local de Saúde do Norte Alentejano, EPE",587,247,834,2019,12,"-7.4263845,39.3003425",4
2019-12-01,Região de Saúde do Centro,"Centro Hospitalar de Leiria, EPE",282,255,537,2019,12,"-8.7982706,39.7414812",2
2019-12-01,Região de Saúde do Centro,"Centro Hospitalar e Universitário de Coimbra, EPE",2659,840,3499,2019,12,"-8.4098211,40.2191523",2
2019-12-01,Região de Saúde do Centro,Centro Medicina de Reabilitação da Região Centro Rovisco Pais,5,0,5,2019,12,"-8.7707806,40.297919",2
2019-12-01,Região de Saúde Norte,"Instituto Português Oncologia do Porto, EPE",80,59,139,2019,12,"-8.6062881,41.1785642",1
2020-01-01,Região de Saúde do Alentejo,"Unidade Local de Saúde do Norte Alentejano, EPE",52,27,79,2020,1,"-7.4263845,39.3003425",4
2020-01-01,Região de Saúde do Algarve,"Centro Hospitalar Universitário do Algarve,EPE",0,0,0,2020,1,"-7.9281554,37.0238973",5
2020-01-01,Região de Saúde LVT,"Centro Hospitalar Universitário de Lisboa Norte, EPE",250,0,250,2020,1,"-9.1616116,38.7500861",3
2020-01-01,Região de Saúde Norte,"Centro Hospitalar Trás-os-Montes e Alto Douro, EPE",77,0,77,2020,1,"-7.7515252,41.3031784",1
2020-01-01,Região de Saúde Norte,"Centro Hospitalar Vila Nova de Gaia/Espinho, EPE",66,0,66,2020,1,"-8.5972617,41.1094138",1
2020-01-01,Região de Saúde Norte,"Hospital de Braga, EPE",415,0,415,2020,1,"-8.398982,41.56785",1
2020-02-01,Região de Saúde do Alentejo,"Unidade Local de Saúde do Norte Alentejano, EPE",94,44,138,2020,2,"-7.4263845,39.3003425",4
2020-02-01,Região de Saúde do Centro,"Centro Hospitalar do Baixo Vouga, EPE",109,101,210,2020,2,"-8.6543716,40.6362453",2
2020-02-01,Região de Saúde do Centro,Hospital Arcebispo João Crisóstomo,58,0,58,2020,2,"-8.5933462,40.3470015",2
2020-02-01,Região de Saúde LVT,"Hospital Garcia de Orta, EPE",0,0,0,2020,2,"-9.1822554,38.6658713",3
2020-02-01,Região de Saúde Norte,"Centro Hospitalar Entre Douro e Vouga, EPE",0,0,0,2020,2,"-8.5458794,40.9293884",1
2020-02-01,Região de Saúde Norte,"Centro Hospitalar Trás-os-Montes e Alto Douro, EPE",126,1,127,2020,2,"-7.7515252,41.3031784",1
2020-02-01,Região de Saúde Norte,"Centro Hospitalar Vila Nova de Gaia/Espinho, EPE",188,0,188,2020,2,"-8.5972617,41.1094138",1
2020-02-01,Região de Saúde Norte,"Hospital de Braga, EPE",720,0,720,2020,2,"-8.398982,41.56785",1
2020-03-01,Região de Saúde do Alentejo,"Unidade Local de Saúde do Baixo Alentejo, EPE",110,918,1028,2020,3,"-7.8721227,38.014123",4
2020-03-01,Região de Saúde LVT,"Centro Hospitalar de Lisboa Ocidental, EPE",85,0,85,2020,3,"-9.216985,38.708454",3
2020-03-01,Região de Saúde LVT,"Centro Hospitalar de Setúbal, EPE",0,0,0,2020,3,"-8.8818638,38.5283754",3
2020-03-01,Região de Saúde LVT,Centro Hospitalar Psiquiátrico de Lisboa,23,1132,1155,2020,3,"-9.1460705,38.7569771",3
2020-03-01,Região de Saúde Norte,"Hospital de Braga, EPE",1136,0,1136,2020,3,"-8.398982,41.56785",1
2020-04-01,Região de Saúde do Centro,"Centro Hospitalar Tondela-Viseu, EPE",75,10,85,2020,4,"-8.0827433,40.516364",2
2020-04-01,Região de Saúde LVT,"Centro Hospitalar Universitário de Lisboa Norte, EPE",832,51,883,2020,4,"-9.1616116,38.7500861",3
2020-05-01,Região de Saúde do Alentejo,"Hospital Espírito Santo de Évora, EPE",464,161,625,2020,5,"-7.9032848,38.5684861",4
2020-05-01,Região de Saúde do Centro,"Centro Hospitalar Universitário Cova da Beira, EPE",108,34,142,2020,5,"-7.4922407,40.2804158",2
2020-05-01,Região de Saúde do Centro,"Centro Hospitalar de Leiria, EPE",127,127,254,2020,5,"-8.7982706,39.7414812",2
2020-05-01,Região de Saúde LVT,"Centro Hospitalar de Lisboa Ocidental, EPE",111,0,111,2020,5,"-9.216985,38.708454",3
2020-05-01,Região de Saúde Norte,"Centro Hospitalar Universitário de São João, EPE",0,0,0,2020,5,"-8.6010558,41.1831056",1
2020-05-01,Região de Saúde Norte,"Centro Hospitalar Universitário do Porto, EPE",743,0,743,2020,5,"-8.6172617,41.1472498",1
2020-05-01,Região de Saúde Norte,"Hospital de Braga, EPE",2635,0,2635,2020,5,"-8.398982,41.56785",1
2020-05-01,Região de Saúde Norte,"Hospital Santa Maria Maior, EPE",0,4,4,2020,5,"-8.6171561,41.5324234",1
2020-05-01,Região de Saúde Norte,"Unidade Local de Saúde de Matosinhos, EPE",0,4074,4074,2020,5,"-8.6745115,41.1794456",1
2020-06-01,Região de Saúde do Alentejo,"Hospital Espírito Santo de Évora, EPE",739,195,934,2020,6,"-7.9032848,38.5684861",4
2020-06-01,Região de Saúde do Centro,"Centro Hospitalar de Leiria, EPE",161,173,334,2020,6,"-8.7982706,39.7414812",2
2020-06-01,Região de Saúde do Centro,"Unidade Local de Saúde de Castelo Branco, EPE",79,52,131,2020,6,"-7.4981271,39.8212263",2
2020-06-01,Região de Saúde LVT,"Centro Hospitalar Médio Tejo, EPE",2,10,12,2020,6,"-8.5404429,39.478072",3
2020-06-01,Região de Saúde Norte,"Centro Hospitalar Universitário de São João, EPE",0,0,0,2020,6,"-8.6010558,41.1831056",1
2020-06-01,Região de Saúde Norte,"Centro Hospitalar Entre Douro e Vouga, EPE",16,33,49,2020,6,"-8.5458794,40.9293884",1
2020-07-01,Região de Saúde do Alentejo,"Unidade Local de Saúde do Litoral Alentejano, EPE",0,0,0,2020,7,"-8.6956768,38.0162314",4
2020-07-01,Região de Saúde do Centro,"Centro Hospitalar e Universitário de Coimbra, EPE",1182,347,1529,2020,7,"-8.4098211,40.2191523",2
2020-07-01,Região de Saúde do Centro,"Centro Hospitalar Tondela-Viseu, EPE",117,18,135,2020,7,"-8.0827433,40.516364",2
2020-08-01,Região de Saúde do Alentejo,"Hospital Espírito Santo de Évora, EPE",1024,215,1239,2020,8,"-7.9032848,38.5684861",4
2020-08-01,Região de Saúde do Algarve,"Centro Hospitalar Universitário do Algarve,EPE",0,0,0,2020,8,"-7.9281554,37.0238973",5
2020-08-01,Região de Saúde do Centro,"Centro Hospitalar Tondela-Viseu, EPE",155,24,179,2020,8,"-8.0827433,40.516364",2
2020-08-01,Região de Saúde do Centro,"Unidade Local de Saúde de Castelo Branco, EPE",106,59,165,2020,8,"-7.4981271,39.8212263",2
2020-08-01,Região de Saúde LVT,"Centro Hospitalar Universitário de Lisboa Norte, EPE",1497,55,1552,2020,8,"-9.1616116,38.7500861",3
2020-08-01,Região de Saúde Norte,"Centro Hospitalar Universitário de São João, EPE",0,0,0,2020,8,"-8.6010558,41.1831056",1
2020-08-01,Região de Saúde Norte,"Centro Hospitalar Entre Douro e Vouga, EPE",19,62,81,2020,8,"-8.5458794,40.9293884",1
2020-09-01,Região de Saúde do Centro,"Centro Hospitalar e Universitário de Coimbra, EPE",1571,504,2075,2020,9,"-8.4098211,40.2191523",2
2020-09-01,Região de Saúde LVT,"Centro Hospitalar Universitário Lisboa Central, EPE",165,1061,1226,2020,9,"-9.1371248,38.7166948",3
2020-09-01,Região de Saúde LVT,"Centro Hospitalar de Lisboa Ocidental, EPE",149,0,149,2020,9,"-9.216985,38.708454",3
2020-09-01,Região de Saúde LVT,"Hospital Garcia de Orta, EPE",0,0,0,2020,9,"-9.1822554,38.6658713",3
2020-10-01,Região de Saúde do Alentejo,"Unidade Local de Saúde do Norte Alentejano, EPE",216,173,389,2020,10,"-7.4263845,39.3003425",4
2020-10-01,Região de Saúde do Algarve,"Centro Hospitalar Universitário do Algarve,EPE",0,0,0,2020,10,"-7.9281554,37.0238973",5
2020-10-01,Região de Saúde do Centro,"Centro Hospitalar de Leiria, EPE",269,318,587,2020,10,"-8.7982706,39.7414812",2
2020-10-01,Região de Saúde do Centro,"Centro Hospitalar do Baixo Vouga, EPE",285,335,620,2020,10,"-8.6543716,40.6362453",2
2020-10-01,Região de Saúde LVT,"Centro Hospitalar Médio Tejo, EPE",3,16,19,2020,10,"-8.5404429,39.478072",3
2020-10-01,Região de Saúde Norte,"Centro Hospitalar Trás-os-Montes e Alto Douro, EPE",586,2,588,2020,10,"-7.7515252,41.3031784",1
2020-11-01,Região de Saúde do Centro,"Centro Hospitalar Universitário Cova da Beira, EPE",235,68,303,2020,11,"-7.4922407,40.2804158",2
2020-11-01,Região de Saúde do Centro,"Centro Hospitalar e Universitário de Coimbra, EPE",2042,669,2711,2020,11,"-8.4098211,40.2191523",2
2020-11-01,Região de Saúde do Centro,"Centro Hospitalar Tondela-Viseu, EPE",223,40,263,2020,11,"-8.0827433,40.516364",2
2020-11-01,Região de Saúde do Centro,Hospital Arcebispo João Crisóstomo,119,0,119,2020,11,"-8.5933462,40.3470015",2
2020-11-01,Região de Saúde LVT,"Centro Hospitalar Universitário Lisboa Central, EPE",250,1348,1598,2020,11,"-9.1371248,38.7166948",3
2020-11-01,Região de Saúde LVT,"Hospital Garcia de Orta, EPE",0,0,0,2020,11,"-9.1822554,38.6658713",3
2020-12-01,Região de Saúde do Alentejo,"Unidade Local de Saúde do Baixo Alentejo, EPE",684,3630,4314,2020,12,"-7.8721227,38.014123",4
2020-12-01,Região de Saúde do Alentejo,"Unidade Local de Saúde do Norte Alentejano, EPE",254,204,458,2020,12,"-7.4263845,39.3003425",4
2020-12-01,Região de Saúde LVT,"Centro Hospitalar Universitário Lisboa Central, EPE",494,1523,2017,2020,12,"-9.1371248,38.7166948",3
2020-12-01,Região de Saúde LVT,"Centro Hospitalar do Oeste, EPE, EPE",64,8,72,2020,12,"-9.1258493,39.4054629",3
2020-12-01,Região de Saúde LVT,"Centro Hospitalar Médio Tejo, EPE",3,18,21,2020,12,"-8.5404429,39.478072",3
2020-12-01,Região de Saúde Norte,"Centro Hospitalar Vila Nova de Gaia/Espinho, EPE",1101,0,1101,2020,12,"-8.5972617,41.1094138",1
2021-01-01,Região de Saúde do Alentejo,"Hospital Espírito Santo de Évora, EPE",64,16,80,2021,1,"-7.9032848,38.5684861",4
2021-01-01,Região de Saúde do Alentejo,"Unidade Local de Saúde do Baixo Alentejo, EPE",132,150,282,2021,1,"-7.8721227,38.014123",4
2021-01-01,Região de Saúde do Centro,"Centro Hospitalar Tondela-Viseu, EPE",20,5,25,2021,1,"-8.0827433,40.516364",2
2021-01-01,Região de Saúde LVT,"Centro Hospitalar Médio Tejo, EPE",0,0,0,2021,1,"-8.5404429,39.478072",3
2021-01-01,Região de Saúde Norte,"Instituto Português Oncologia do Porto, EPE",3,2,5,2021,1,"-8.6062881,41.1785642",1
2021-02-01,Região de Saúde do Algarve,"Centro Hospitalar Universitário do Algarve,EPE",0,0,0,2021,2,"-7.9281554,37.0238973",5
2021-02-01,Região de Saúde do Centro,"Centro Hospitalar Tondela-Viseu, EPE",36,9,45,2021,2,"-8.0827433,40.516364",2
2021-02-01,Região de Saúde do Centro,"Hospital Distrital da Figueira da Foz, EPE",904,2758,3662,2021,2,"-8.8586755,40.117897",2
2021-02-01,Região de Saúde LVT,"Centro Hospitalar Universitário de Lisboa Norte, EPE",289,6,295,2021,2,"-9.1616116,38.7500861",3
2021-02-01,Região de Saúde Norte,"Centro Hospitalar Póvoa de Varzim/Vila do Conde, EPE",115,86,201,2021,2,"-8.7589945,41.3828711",1
2021-02-01,Região de Saúde Norte,"Instituto Português Oncologia do Porto, EPE",7,4,11,2021,2,"-8.6062881,41.1785642",1
2021-03-01,Região de Saúde do Algarve,"Centro Hospitalar Universitário do Algarve,EPE",0,0,0,2021,3,"-7.9281554,37.0238973",5
2021-03-01,Região de Saúde do Centro,"Centro Hospitalar Universitário Cova da Beira, EPE",3309,9977,13286,2021,3,"-7.4922407,40.2804158",2
2021-03-01,Região de Saúde LVT,"Centro Hospitalar de Setúbal, EPE",177,149,326,2021,3,"-8.8818638,38.5283754",3
2021-03-01,Região de Saúde LVT,"Centro Hospitalar do Oeste, EPE, EPE",2406,11426,13832,2021,3,"-9.1258493,39.4054629",3
2021-03-01,Região de Saúde LVT,"Centro Hospitalar Médio Tejo, EPE",0,0,0,2021,3,"-8.5404429,39.478072",3
2021-03-01,Região de Saúde LVT,"Hospital Garcia de Orta, EPE",3,1,4,2021,3,"-9.1822554,38.6658713",3
2021-03-01,Região de Saúde Norte,"Instituto Português Oncologia do Porto, EPE",18,10,28,2021,3,"-8.6062881,41.1785642",1
2021-04-01,Região de Saúde do Algarve,"Centro Hospitalar Universitário do Algarve,EPE",0,0,0,2021,4,"-7.9281554,37.0238973",5
2021-04-01,Região de Saúde do Centro,"Centro Hospitalar de Leiria, EPE",129,84,213,2021,4,"-8.7982706,39.7414812",2
2021-04-01,Região de Saúde do Centro,Hospital Arcebispo João Crisóstomo,41,0,41,2021,4,"-8.5933462,40.3470015",2
2021-04-01,Região de Saúde do Centro,"Hospital Distrital da Figueira da Foz, EPE",1496,4399,5895,2021,4,"-8.8586755,40.117897",2
2021-04-01,Região de Saúde do Centro,"Unidade Local de Saúde de Castelo Branco, EPE",106,81,187,2021,4,"-7.4981271,39.8212263",2
2021-04-01,Região de Saúde LVT,"Centro Hospitalar de Lisboa Ocidental, EPE",45,0,45,2021,4,"-9.216985,38.708454",3
2021-04-01,Região de Saúde Norte,"Centro Hospitalar Universitário do Porto, EPE",605,0,605,2021,4,"-8.6172617,41.1472498",1
2021-04-01,Região de Saúde Norte,"Hospital de Braga, EPE",115,0,115,2021,4,"-8.398982,41.56785",1
2021-05-01,Região de Saúde do Alentejo,"Unidade Local de Saúde do Baixo Alentejo, EPE",761,871,1632,2021,5,"-7.8721227,38.014123",4
2021-05-01,Região de Saúde do Centro,Hospital Arcebispo João Crisóstomo,51,0,51,2021,5,"-8.5933462,40.3470015",2
2021-05-01,Região de Saúde LVT,"Centro Hospitalar Médio Tejo, EPE",0,0,0,2021,5,"-8.5404429,39.478072",3
2021-05-01,Região de Saúde Norte,"Centro Hospitalar Entre Douro e Vouga, EPE",56,13,69,2021,5,"-8.5458794,40.9293884",1
2021-05-01,Região de Saúde Norte,"Centro Hospitalar Trás-os-Montes e Alto Douro, EPE",265,0,265,2021,5,"-7.7515252,41.3031784",1
2021-06-01,Região de Saúde do Algarve,"Centro Hospitalar Universitário do Algarve,EPE",0,0,0,2021,6,"-7.9281554,37.0238973",5
2021-06-01,Região de Saúde LVT,"Centro Hospitalar de Setúbal, EPE",448,315,763,2021,6,"-8.8818638,38.5283754",3
2021-06-01,Região de Saúde LVT,Centro Hospitalar Psiquiátrico de Lisboa,276,4832,5108,2021,6,"-9.1460705,38.7569771",3
2021-06-01,Região de Saúde Norte,"Hospital de Magalhães Lemos, EPE",0,2200,2200,2021,6,"-8.6649823,41.1764649",1
2021-06-01,Região de Saúde Norte,"Instituto Português Oncologia do Porto, EPE",45,34,79,2021,6,"-8.6062881,41.1785642",1
2021-07-01,Região de Saúde do Centro,"Centro Hospitalar Tondela-Viseu, EPE",127,44,171,2021,7,"-8.0827433,40.516364",2
2021-07-01,Região de Saúde LVT,"Centro Hospitalar de Lisboa Ocidental, EPE",100,0,100,2021,7,"-9.216985,38.708454",3
2021-07-01,Região de Saúde LVT,"Centro Hospitalar de Setúbal, EPE",529,350,879,2021,7,"-8.8818638,38.5283754",3
2021-07-01,Região de Saúde LVT,"Centro Hospitalar Universitário de Lisboa Norte, EPE",2082,588,2670,2021,7,"-9.1616116,38.7500861",3
2021-07-01,Região de Saúde Norte,"Centro Hospitalar Universitário do Porto, EPE",1316,0,1316,2021,7,"-8.6172617,41.1472498",1
2021-08-01,Região de Saúde do Alentejo,"Unidade Local de Saúde do Norte Alentejano, EPE",155,105,260,2021,8,"-7.4263845,39.3003425",4
2021-08-01,Região de Saúde LVT,"Centro Hospitalar Universitário Lisboa Central, EPE",0,1844,1844,2021,8,"-9.1371248,38.7166948",3
2021-08-01,Região de Saúde LVT,"Centro Hospitalar de Lisboa Ocidental, EPE",104,0,104,2021,8,"-9.216985,38.708454",3
2021-08-01,Região de Saúde LVT,Centro Hospitalar Psiquiátrico de Lisboa,356,6106,6462,2021,8,"-9.1460705,38.7569771",3
2021-08-01,Região de Saúde Norte,"Unidade Local de Saúde de Matosinhos, EPE",0,6370,6370,2021,8,"-8.6745115,41.1794456",1
2021-09-01,Região de Saúde do Alentejo,"Unidade Local de Saúde do Baixo Alentejo, EPE",1202,1201,2403,2021,9,"-7.8721227,38.014123",4
2021-09-01,Região de Saúde LVT,"Hospital Professor Doutor Fernando Fonseca, EPE",4,77,81,2021,9,"-9.2264834,38.7422257",3
2021-09-01,Região de Saúde Norte,"Centro Hospitalar do Médio Ave, EPE",75,809,884,2021,9,"-8.4802503,41.3423984",1
2021-09-01,Região de Saúde Norte,"Centro Hospitalar Póvoa de Varzim/Vila do Conde, EPE",438,264,702,2021,9,"-8.7589945,41.3828711",1
2021-09-01,Região de Saúde Norte,"Centro Hospitalar Trás-os-Montes e Alto Douro, EPE",492,1,493,2021,9,"-7.7515252,41.3031784",1
2021-10-01,Região de Saúde do Alentejo,"Unidade Local de Saúde do Baixo Alentejo, EPE",1302,1276,2578,2021,10,"-7.8721227,38.014123",4
2021-10-01,Região de Saúde do Alentejo,"Unidade Local de Saúde do Litoral Alentejano, EPE",11,0,11,2021,10,"-8.6956768,38.0162314",4
2021-10-01,Região de Saúde do Centro,"Centro Hospitalar Universitário Cova da Beira, EPE",8430,20464,28894,2021,10,"-7.4922407,40.2804158",2
2021-10-01,Região de Saúde do Centro,"Centro Hospitalar de Leiria, EPE",262,188,450,2021,10,"-8.7982706,39.7414812",2
2021-10-01,Região de Saúde do Centro,"Centro Hospitalar do Baixo Vouga, EPE",325,303,628,2021,10,"-8.6543716,40.6362453",2
2021-10-01,Região de Saúde do Centro,Centro Medicina de Reabilitação da Região Centro Rovisco Pais,1,1,2,2021,10,"-8.7707806,40.297919",2
2021-10-01,Região de Saúde do Centro,"Unidade Local de Saúde de Castelo Branco, EPE",139,123,262,2021,10,"-7.4981271,39.8212263",2
2021-10-01,Região de Saúde Norte,"Centro Hospitalar Trás-os-Montes e Alto Douro, EPE",550,1,551,2021,10,"-7.7515252,41.3031784",1
2021-10-01,Região de Saúde Norte,"Hospital de Magalhães Lemos, EPE",0,2200,2200,2021,10,"-8.6649823,41.1764649",1
2021-11-01,Região de Saúde do Alentejo,"Unidade Local de Saúde do Litoral Alentejano, EPE",12,0,12,2021,11,"-8.6956768,38.0162314",4
2021-11-01,Região de Saúde do Algarve,"Centro Hospitalar Universitário do Algarve,EPE",0,0,0,2021,11,"-7.9281554,37.0238973",5
2021-11-01,Região de Saúde do Centro,"Hospital Distrital da Figueira da Foz, EPE",3338,7078,10416,2021,11,"-8.8586755,40.117897",2
2021-11-01,Região de Saúde LVT,"Centro Hospitalar Universitário Lisboa Central, EPE",5729,2050,7779,2021,11,"-9.1371248,38.7166948",3
2021-11-01,Região de Saúde LVT,"Hospital Distrital de Santarém, EPE",3,38,41,2021,11,"-8.6937515,39.2410946",3
2021-11-01,Região de Saúde LVT,"Hospital Professor Doutor Fernando Fonseca, EPE",5,122,127,2021,11,"-9.2264834,38.7422257",3
2021-11-01,Região de Saúde Norte,"Centro Hospitalar Trás-os-Montes e Alto Douro, EPE",623,1,624,2021,11,"-7.7515252,41.3031784",1
2021-11-01,Região de Saúde Norte,"Hospital de Magalhães Lemos, EPE",0,2200,2200,2021,11,"-8.6649823,41.1764649",1
2021-11-01,Região de Saúde Norte,"Unidade Local de Saúde de Matosinhos, EPE",0,8715,8715,2021,11,"-8.6745115,41.1794456",1
2021-11-01,Região de Saúde Norte,"Unidade Local de Saúde do Alto Minho, EPE",18,11,29,2021,11,"-8.8252713,41.7056054",1
2021-12-01,Região de Saúde do Centro,"Centro Hospitalar de Leiria, EPE",305,214,519,2021,12,"-8.7982706,39.7414812",2
2021-12-01,Região de Saúde do Centro,"Unidade Local de Saúde de Castelo Branco, EPE",289,134,423,2021,12,"-7.4981271,39.8212263",2
2021-12-01,Região de Saúde LVT,"Centro Hospitalar Universitário Lisboa Central, EPE",6246,2225,8471,2021,12,"-9.1371248,38.7166948",3
2021-12-01,Região de Saúde LVT,"Centro Hospitalar Médio Tejo, EPE",0,0,0,2021,12,"-8.5404429,39.478072",3
2021-12-01,Região de Saúde LVT,"Hospital Professor Doutor Fernando Fonseca, EPE",6158,43599,49757,2021,12,"-9.2264834,38.7422257",3
2021-12-01,Região de Saúde Norte,"Centro Hospitalar Universitário de São João, EPE",0,0,0,2021,12,"-8.6010558,41.1831056",1
2021-12-01,Região de Saúde Norte,"Centro Hospitalar do Médio Ave, EPE",154,2875,3029,2021,12,"-8.4802503,41.3423984",1
2021-12-01,Região de Saúde Norte,"Instituto Português Oncologia do Porto, EPE",94,98,192,2021,12,"-8.6062881,41.1785642",1
2022-01-01,Região de Saúde do Centro,"Unidade Local de Saúde de Castelo Branco, EPE",0,2,2,2022,1,"-7.4981271,39.8212263",2
2022-01-01,Região de Saúde LVT,"Centro Hospitalar Barreiro/Montijo, EPE",1,20,21,2022,1,"-9.0592392,38.6554005",3
2022-01-01,Região de Saúde LVT,"Centro Hospitalar Médio Tejo, EPE",0,0,0,2022,1,"-8.5404429,39.478072",3
2022-01-01,Região de Saúde Norte,"Centro Hospitalar Universitário do Porto, EPE",224,0,224,2022,1,"-8.6172617,41.1472498",1
2022-01-01,Região de Saúde Norte,"Centro Hospitalar Trás-os-Montes e Alto Douro, EPE",16,0,16,2022,1,"-7.7515252,41.3031784",1
2022-02-01,Região de Saúde do Alentejo,"Unidade Local de Saúde do Litoral Alentejano, EPE",5,0,5,2022,2,"-8.6956768,38.0162314",4
2022-02-01,Região de Saúde do Alentejo,"Unidade Local de Saúde do Norte Alentejano, EPE",143,7,150,2022,2,"-7.4263845,39.3003425",4
2022-02-01,Região de Saúde do Algarve,"Centro Hospitalar Universitário do Algarve,EPE",0,0,0,2022,2,"-7.9281554,37.0238973",5
2022-02-01,Região de Saúde do Centro,"Centro Hospitalar Universitário Cova da Beira, EPE",1246,3117,4363,2022,2,"-7.4922407,40.2804158",2
2022-02-01,Região de Saúde LVT,Centro Hospitalar Psiquiátrico de Lisboa,109,1562,1671,2022,2,"-9.1460705,38.7569771",3
2022-02-01,Região de Saúde LVT,"Hospital Professor Doutor Fernando Fonseca, EPE",745,6539,7284,2022,2,"-9.2264834,38.7422257",3
2022-02-01,Região de Saúde Norte,"Centro Hospitalar do Médio Ave, EPE",31,942,973,2022,2,"-8.4802503,41.3423984",1
2022-02-01,Região de Saúde Norte,"Hospital da Senhora da Oliveira, Guimarães, EPE",198,0,198,2022,2,"-8.3086907,41.4387173",1
2022-02-01,Região de Saúde Norte,"Hospital de Braga, EPE",155,0,155,2022,2,"-8.398982,41.56785",1
2022-02-01,Região de Saúde Norte,"Instituto Português Oncologia do Porto, EPE",22,27,49,2022,2,"-8.6062881,41.1785642",1
2022-03-01,Região de Saúde do Alentejo,"Hospital Espírito Santo de Évora, EPE",340,40,380,2022,3,"-7.9032848,38.5684861",4
2022-03-01,Região de Saúde do Centro,"Centro Hospitalar do Baixo Vouga, EPE",117,125,242,2022,3,"-8.6543716,40.6362453",2
2022-03-01,Região de Saúde do Centro,"Centro Hospitalar Tondela-Viseu, EPE",92,40,132,2022,3,"-8.0827433,40.516364",2
2022-03-01,Região de Saúde LVT,"Centro Hospitalar Universitário Lisboa Central, EPE",607,767,1374,2022,3,"-9.1371248,38.7166948",3
2022-03-01,Região de Saúde LVT,"Centro Hospitalar de Setúbal, EPE",263,255,518,2022,3,"-8.8818638,38.5283754",3
2022-03-01,Região de Saúde LVT,"Centro Hospitalar do Oeste, EPE, EPE",1913,4000,5913,2022,3,"-9.1258493,39.4054629",3
2022-03-01,Região de Saúde LVT,Centro Hospitalar Psiquiátrico de Lisboa,154,2289,2443,2022,3,"-9.1460705,38.7569771",3
2022-03-01,Região de Saúde LVT,"Hospital de Vila Franca de Xira, EPE",95,2379,2474,2022,3,"-8.984506,38.977235",3
2022-04-01,Região de Saúde do Centro,"Centro Hospitalar de Leiria, EPE",104,70,174,2022,4,"-8.7982706,39.7414812",2
2022-04-01,Região de Saúde do Centro,"Centro Hospitalar e Universitário de Coimbra, EPE",951,872,1823,2022,4,"-8.4098211,40.2191523",2
2022-04-01,Região de Saúde do Centro,"Unidade Local de Saúde de Castelo Branco, EPE",1480,1982,3462,2022,4,"-7.4981271,39.8212263",2
2022-04-01,Região de Saúde LVT,"Centro Hospitalar Barreiro/Montijo, EPE",483,511,994,2022,4,"-9.0592392,38.6554005",3
2022-04-01,Região de Saúde LVT,"Centro Hospitalar Universitário de Lisboa Norte, EPE",1798,298,2096,2022,4,"-9.1616116,38.7500861",3
2022-04-01,Região de Saúde LVT,"Hospital Professor Doutor Fernando Fonseca, EPE",1338,12340,13678,2022,4,"-9.2264834,38.7422257",3
2022-04-01,Região de Saúde Norte,"Centro Hospitalar Universitário de São João, EPE",0,0,0,2022,4,"-8.6010558,41.1831056",1
2022-04-01,Região de Saúde Norte,"Centro Hospitalar Universitário do Porto, EPE",1028,0,1028,2022,4,"-8.6172617,41.1472498",1
2022-04-01,Região de Saúde Norte,"Hospital de Magalhães Lemos, EPE",0,922,922,2022,4,"-8.6649823,41.1764649",1
2022-04-01,Região de Saúde Norte,"Unidade Local de Saúde de Matosinhos, EPE",0,2898,2898,2022,4,"-8.6745115,41.1794456",1
2022-05-01,Região de Saúde do Alentejo,"Unidade Local de Saúde do Litoral Alentejano, EPE",17,0,17,2022,5,"-8.6956768,38.0162314",4
2022-05-01,Região de Saúde LVT,"Centro Hospitalar Barreiro/Montijo, EPE",665,888,1553,2022,5,"-9.0592392,38.6554005",3
2022-05-01,Região de Saúde LVT,"Centro Hospitalar Universitário de Lisboa Norte, EPE",2571,359,2930,2022,5,"-9.1616116,38.7500861",3
2022-05-01,Região de Saúde LVT,"Centro Hospitalar Médio Tejo, EPE",0,0,0,2022,5,"-8.5404429,39.478072",3
2022-05-01,Região de Saúde LVT,Centro Hospitalar Psiquiátrico de Lisboa,211,3796,4007,2022,5,"-9.1460705,38.7569771",3
2022-05-01,Região de Saúde Norte,"Unidade Local de Saúde de Matosinhos, EPE",0,3569,3569,2022,5,"-8.6745115,41.1794456",1
2022-06-01,Região de Saúde do Alentejo,"Hospital Espírito Santo de Évora, EPE",705,93,798,2022,6,"-7.9032848,38.5684861",4
2022-06-01,Região de Saúde do Alentejo,"Unidade Local de Saúde do Norte Alentejano, EPE",375,68,443,2022,6,"-7.4263845,39.3003425",4
2022-06-01,Região de Saúde LVT,"Centro Hospitalar de Setúbal, EPE",426,520,946,2022,6,"-8.8818638,38.5283754",3
2022-06-01,Região de Saúde LVT,Centro Hospitalar Psiquiátrico de Lisboa,244,4410,4654,2022,6,"-9.1460705,38.7569771",3
2022-06-01,Região de Saúde LVT,"Hospital Professor Doutor Fernando Fonseca, EPE",1994,18064,20058,2022,6,"-9.2264834,38.7422257",3
2022-06-01,Região de Saúde Norte,"Centro Hospitalar do Médio Ave, EPE",109,2499,2608,2022,6,"-8.4802503,41.3423984",1
2022-06-01,Região de Saúde Norte,"Unidade Local de Saúde de Matosinhos, EPE",0,4306,4306,2022,6,"-8.6745115,41.1794456",1
2022-07-01,Região de Saúde do Alentejo,"Unidade Local de Saúde do Litoral Alentejano, EPE",17,0,17,2022,7,"-8.6956768,38.0162314",4
2022-07-01,Região de Saúde do Centro,Centro Medicina de Reabilitação da Região Centro Rovisco Pais,30,6,36,2022,7,"-8.7707806,40.297919",2
2022-07-01,Região de Saúde LVT,"Hospital de Vila Franca de Xira, EPE",199,6822,7021,2022,7,"-8.984506,38.977235",3
2022-07-01,Região de Saúde Norte,"Hospital de Magalhães Lemos, EPE",0,1723,1723,2022,7,"-8.6649823,41.1764649",1
2022-07-01,Região de Saúde Norte,"Unidade Local de Saúde de Matosinhos, EPE",0,4959,4959,2022,7,"-8.6745115,41.1794456",1
2022-08-01,Região de Saúde do Alentejo,"Hospital Espírito Santo de Évora, EPE",866,134,1000,2022,8,"-7.9032848,38.5684861",4
2022-08-01,Região de Saúde do Algarve,"Centro Hospitalar Universitário do Algarve,EPE",0,0,0,2022,8,"-7.9281554,37.0238973",5
2022-08-01,Região de Saúde do Centro,"Hospital Distrital da Figueira da Foz, EPE",1599,2603,4202,2022,8,"-8.8586755,40.117897",2
2022-08-01,Região de Saúde do Centro,"Unidade Local de Saúde de Castelo Branco, EPE",2906,3139,6045,2022,8,"-7.4981271,39.8212263",2
2022-08-01,Região de Saúde LVT,"Hospital Garcia de Orta, EPE",1321,12512,13833,2022,8,"-9.1822554,38.6658713",3
2022-08-01,Região de Saúde Norte,"Centro Hospitalar Universitário de São João, EPE",0,0,0,2022,8,"-8.6010558,41.1831056",1
2022-08-01,Região de Saúde Norte,"Hospital de Braga, EPE",553,0,553,2022,8,"-8.398982,41.56785",1
2022-09-01,Região de Saúde do Centro,"Unidade Local de Saúde de Castelo Branco, EPE",3305,3561,6866,2022,9,"-7.4981271,39.8212263",2
2022-09-01,Região de Saúde LVT,"Centro Hospitalar Universitário de Lisboa Norte, EPE",4967,496,5463,2022,9,"-9.1616116,38.7500861",3
2022-09-01,Região de Saúde LVT,"Centro Hospitalar Médio Tejo, EPE",0,0,0,2022,9,"-8.5404429,39.478072",3
2022-09-01,Região de Saúde Norte,"Centro Hospitalar Universitário de São João, EPE",0,0,0,2022,9,"-8.6010558,41.1831056",1
2022-09-01,Região de Saúde Norte,"Instituto Português Oncologia do Porto, EPE",102,122,224,2022,9,"-8.6062881,41.1785642",1
2022-09-01,Região de Saúde Norte,"Unidade Local de Saúde de Matosinhos, EPE",0,6316,6316,2022,9,"-8.6745115,41.1794456",1
2022-10-01,Região de Saúde do Centro,"Hospital Distrital da Figueira da Foz, EPE",1754,3026,4780,2022,10,"-8.8586755,40.117897",2
2022-10-01,Região de Saúde do Centro,"Unidade Local de Saúde de Castelo Branco, EPE",3635,3914,7549,2022,10,"-7.4981271,39.8212263",2
2022-10-01,Região de Saúde LVT,"Centro Hospitalar Barreiro/Montijo, EPE",1338,2117,3455,2022,10,"-9.0592392,38.6554005",3
2022-10-01,Região de Saúde LVT,"Hospital Distrital de Santarém, EPE",6,77,83,2022,10,"-8.6937515,39.2410946",3
2022-10-01,Região de Saúde LVT,"Hospital Professor Doutor Fernando Fonseca, EPE",3282,28229,31511,2022,10,"-9.2264834,38.7422257",3
2022-10-01,Região de Saúde Norte,"Centro Hospitalar Universitário de São João, EPE",0,0,0,2022,10,"-8.6010558,41.1831056",1
2022-10-01,Região de Saúde Norte,"Instituto Português Oncologia do Porto, EPE",110,139,249,2022,10,"-8.6062881,41.1785642",1
2022-11-01,Região de Saúde do Alentejo,"Unidade Local de Saúde do Norte Alentejano, EPE",593,243,836,2022,11,"-7.4263845,39.3003425",4
2022-11-01,Região de Saúde do Algarve,"Centro Hospitalar Universitário do Algarve,EPE",0,0,0,2022,11,"-7.9281554,37.0238973",5
2022-11-01,Região de Saúde do Centro,"Centro Hospitalar do Baixo Vouga, EPE",451,402,853,2022,11,"-8.6543716,40.6362453",2
2022-11-01,Região de Saúde do Centro,"Unidade Local de Saúde de Castelo Branco, EPE",3995,4284,8279,2022,11,"-7.4981271,39.8212263",2
2022-11-01,Região de Saúde Norte,"Centro Hospitalar do Médio Ave, EPE",221,4329,4550,2022,11,"-8.4802503,41.3423984",1
2022-11-01,Região de Saúde Norte,"Centro Hospitalar Póvoa de Varzim/Vila do Conde, EPE",485,11,496,2022,11,"-8.7589945,41.3828711",1
2022-11-01,Região de Saúde Norte,"Centro Hospitalar Trás-os-Montes e Alto Douro, EPE",259,0,259,2022,11,"-7.7515252,41.3031784",1
2022-11-01,Região de Saúde Norte,"Hospital da Senhora da Oliveira, Guimarães, EPE",762,0,762,2022,11,"-8.3086907,41.4387173",1
2022-11-01,Região de Saúde Norte,"Hospital de Braga, EPE",672,0,672,2022,11,"-8.398982,41.56785",1
2022-11-01,Região de Saúde Norte,"Unidade Local de Saúde de Matosinhos, EPE",0,7675,7675,2022,11,"-8.6745115,41.1794456",1
2022-12-01,Região de Saúde LVT,"Hospital Distrital de Santarém, EPE",8,105,113,2022,12,"-8.6937515,39.2410946",3
2022-12-01,Região de Saúde Norte,"Hospital de Magalhães Lemos, EPE",0,4472,4472,2022,12,"-8.6649823,41.1764649",1
2022-12-01,Região de Saúde Norte,"Instituto Português Oncologia do Porto, EPE",134,163,297,2022,12,"-8.6062881,41.1785642",1
2023-01-01,Região de Saúde do Centro,"Centro Hospitalar de Leiria, EPE",28,27,55,2023,1,"-8.7982706,39.7414812",2
2023-01-01,Região de Saúde do Centro,"Centro Hospitalar e Universitário de Coimbra, EPE",519,250,769,2023,1,"-8.4098211,40.2191523",2
2023-01-01,Região de Saúde do Centro,"Centro Hospitalar Tondela-Viseu, EPE",41,12,53,2023,1,"-8.0827433,40.516364",2
2023-01-01,Região de Saúde do Centro,"Hospital Distrital da Figueira da Foz, EPE",78,190,268,2023,1,"-8.8586755,40.117897",2
2023-01-01,Região de Saúde LVT,"Centro Hospitalar de Lisboa Ocidental, EPE",18,185,203,2023,1,"-9.216985,38.708454",3
2023-01-01,Região de Saúde LVT,"Centro Hospitalar de Setúbal, EPE",19,18,37,2023,1,"-8.8818638,38.5283754",3
2023-01-01,Região de Saúde LVT,"Centro Hospitalar Médio Tejo, EPE",0,0,0,2023,1,"-8.5404429,39.478072",3
2023-01-01,Região de Saúde LVT,"Hospital Garcia de Orta, EPE",72,934,1006,2023,1,"-9.1822554,38.6658713",3
2023-01-01,Região de Saúde Norte,"Centro Hospitalar do Médio Ave, EPE",31,436,467,2023,1,"-8.4802503,41.3423984",1
2023-01-01,Região de Saúde Norte,"Centro Hospitalar Universitário do Porto, EPE",255,0,255,2023,1,"-8.6172617,41.1472498",1
2023-01-01,Região de Saúde Norte,"Centro Hospitalar Póvoa de Varzim/Vila do Conde, EPE",36,0,36,2023,1,"-8.7589945,41.3828711",1
2023-01-01,Região de Saúde Norte,"Hospital de Magalhães Lemos, EPE",0,222,222,2023,1,"-8.6649823,41.1764649",1
2023-02-01,Região de Saúde LVT,"Centro Hospitalar de Setúbal, EPE",27,33,60,2023,2,"-8.8818638,38.5283754",3
2023-02-01,Região de Saúde Norte,"Hospital da Senhora da Oliveira, Guimarães, EPE",228,0,228,2023,2,"-8.3086907,41.4387173",1
2023-02-01,Região de Saúde Norte,"Unidade Local de Saúde do Alto Minho, EPE",0,27,27,2023,2,"-8.8252713,41.7056054",1
2023-03-01,Região de Saúde do Centro,"Centro Hospitalar e Universitário de Coimbra, EPE",1503,769,2272,2023,3,"-8.4098211,40.2191523",2
2023-03-01,Região de Saúde do Centro,"Centro Hospitalar Tondela-Viseu, EPE",86,28,114,2023,3,"-8.0827433,40.516364",2
2023-03-01,Região de Saúde LVT,"Centro Hospitalar Universitário Lisboa Central, EPE",302,1363,1665,2023,3,"-9.1371248,38.7166948",3
2023-03-01,Região de Saúde LVT,"Hospital Professor Doutor Fernando Fonseca, EPE",857,7741,8598,2023,3,"-9.2264834,38.7422257",3
2023-03-01,Região de Saúde Norte,"Centro Hospitalar Vila Nova de Gaia/Espinho, EPE",96,0,96,2023,3,"-8.5972617,41.1094138",1
2023-04-01,Região de Saúde do Algarve,"Centro Hospitalar Universitário do Algarve,EPE",0,0,0,2023,4,"-7.9281554,37.0238973",5
2023-04-01,Região de Saúde do Centro,"Centro Hospitalar do Baixo Vouga, EPE",174,172,346,2023,4,"-8.6543716,40.6362453",2
2023-04-01,Região de Saúde LVT,"Centro Hospitalar Universitário de Lisboa Norte, EPE",2234,14,2248,2023,4,"-9.1616116,38.7500861",3
2023-04-01,Região de Saúde Norte,"Centro Hospitalar Universitário de São João, EPE",0,0,0,2023,4,"-8.6010558,41.1831056",1
2023-04-01,Região de Saúde Norte,"Centro Hospitalar Entre Douro e Vouga, EPE",46,45,91,2023,4,"-8.5458794,40.9293884",1
2023-04-01,Região de Saúde Norte,"Centro Hospitalar Póvoa de Varzim/Vila do Conde, EPE",153,4,157,2023,4,"-8.7589945,41.3828711",1
2023-04-01,Região de Saúde Norte,"Instituto Português Oncologia do Porto, EPE",64,67,131,2023,4,"-8.6062881,41.1785642",1
2023-05-01,Região de Saúde do Centro,"Centro Hospitalar do Baixo Vouga, EPE",220,221,441,2023,5,"-8.6543716,40.6362453",2
2023-05-01,Região de Saúde do Centro,"Hospital Distrital da Figueira da Foz, EPE",440,1088,1528,2023,5,"-8.8586755,40.117897",2
2023-05-01,Região de Saúde LVT,"Centro Hospitalar de Lisboa Ocidental, EPE",125,1024,1149,2023,5,"-9.216985,38.708454",3
2023-05-01,Região de Saúde LVT,"Centro Hospitalar de Setúbal, EPE",78,165,243,2023,5,"-8.8818638,38.5283754",3
2023-05-01,Região de Saúde LVT,"Centro Hospitalar Médio Tejo, EPE",0,0,0,2023,5,"-8.5404429,39.478072",3
2023-05-01,Região de Saúde LVT,"Hospital Garcia de Orta, EPE",285,4576,4861,2023,5,"-9.1822554,38.6658713",3
2023-05-01,Região de Saúde Norte,"Centro Hospitalar Póvoa de Varzim/Vila do Conde, EPE",190,10,200,2023,5,"-8.7589945,41.3828711",1
2023-05-01,Região de Saúde Norte,"Hospital da Senhora da Oliveira, Guimarães, EPE",520,0,520,2023,5,"-8.3086907,41.4387173",1
2023-06-01,Região de Saúde do Alentejo,"Hospital Espírito Santo de Évora, EPE",502,139,641,2023,6,"-7.9032848,38.5684861",4
2023-06-01,Região de Saúde LVT,"Centro Hospitalar Barreiro/Montijo, EPE",1474,1787,3261,2023,6,"-9.0592392,38.6554005",3
2023-06-01,Região de Saúde LVT,"Centro Hospitalar de Setúbal, EPE",85,206,291,2023,6,"-8.8818638,38.5283754",3
2023-06-01,Região de Saúde LVT,"Centro Hospitalar Universitário de Lisboa Norte, EPE",3638,32,3670,2023,6,"-9.1616116,38.7500861",3
2023-06-01,Região de Saúde LVT,"Hospital de Vila Franca de Xira, EPE",121,0,121,2023,6,"-8.984506,38.977235",3
2023-06-01,Região de Saúde Norte,"Centro Hospitalar Entre Douro e Vouga, EPE",116,65,181,2023,6,"-8.5458794,40.9293884",1
2023-06-01,Região de Saúde Norte,"Unidade Local de Saúde do Alto Minho, EPE",3,54,57,2023,6,"-8.8252713,41.7056054",1
2023-07-01,Região de Saúde do Centro,"Centro Hospitalar Universitário Cova da Beira, EPE",2723,8111,10834,2023,7,"-7.4922407,40.2804158",2
2023-07-01,Região de Saúde do Centro,"Centro Hospitalar Tondela-Viseu, EPE",232,64,296,2023,7,"-8.0827433,40.516364",2
2023-07-01,Região de Saúde LVT,"Centro Hospitalar Barreiro/Montijo, EPE",1708,2036,3744,2023,7,"-9.0592392,38.6554005",3
2023-07-01,Região de Saúde LVT,"Hospital Garcia de Orta, EPE",372,6245,6617,2023,7,"-9.1822554,38.6658713",3
2023-07-01,Região de Saúde Norte,"Hospital da Senhora da Oliveira, Guimarães, EPE",699,0,699,2023,7,"-8.3086907,41.4387173",1
2023-07-01,Região de Saúde Norte,"Unidade Local de Saúde de Matosinhos, EPE",0,4697,4697,2023,7,"-8.6745115,41.1794456",1
2023-08-01,Região de Saúde do Algarve,"Centro Hospitalar Universitário do Algarve,EPE",0,0,0,2023,8,"-7.9281554,37.0238973",5
2023-08-01,Região de Saúde do Centro,"Centro Hospitalar e Universitário de Coimbra, EPE",4635,2256,6891,2023,8,"-8.4098211,40.2191523",2
2023-08-01,Região de Saúde Norte,"Centro Hospitalar Universitário de São João, EPE",0,0,0,2023,8,"-8.6010558,41.1831056",1
2023-08-01,Região de Saúde Norte,"Centro Hospitalar Universitário de Santo António, EPE",1641,1507,3148,2023,8,"-8.6172617,41.1472498",1
2023-08-01,Região de Saúde Norte,"Hospital da Senhora da Oliveira, Guimarães, EPE",740,0,740,2023,8,"-8.3086907,41.4387173",1
2023-08-01,Região de Saúde Norte,"Hospital de Braga, EPE",353,0,353,2023,8,"-8.398982,41.56785",1
2023-08-01,Região de Saúde Norte,"Unidade Local de Saúde de Matosinhos, EPE",0,5401,5401,2023,8,"-8.6745115,41.1794456",1
2023-08-01,Região de Saúde Norte,"Unidade Local de Saúde do Alto Minho, EPE",3,57,60,2023,8,"-8.8252713,41.7056054",1
2023-09-01,Região de Saúde do Alentejo,"Unidade Local de Saúde do Baixo Alentejo, EPE",266,546,812,2023,9,"-7.8721227,38.014123",4
2023-09-01,Região de Saúde do Alentejo,"Unidade Local de Saúde do Litoral Alentejano, EPE",39,10,49,2023,9,"-8.6956768,38.0162314",4
2023-09-01,Região de Saúde do Centro,"Centro Hospitalar Universitário Cova da Beira, EPE",3442,10083,13525,2023,9,"-7.4922407,40.2804158",2
2023-09-01,Região de Saúde do Centro,"Centro Hospitalar de Leiria, EPE",223,241,464,2023,9,"-8.7982706,39.7414812",2
2023-09-01,Região de Saúde LVT,"Centro Hospitalar do Oeste, EPE, EPE",3855,6933,10788,2023,9,"-9.1258493,39.4054629",3
2023-09-01,Região de Saúde Norte,"Centro Hospitalar do Médio Ave, EPE",213,3694,3907,2023,9,"-8.4802503,41.3423984",1
2023-09-01,Região de Saúde Norte,"Hospital da Senhora da Oliveira, Guimarães, EPE",839,0,839,2023,9,"-8.3086907,41.4387173",1
2023-10-01,Região de Saúde do Alentejo,"Unidade Local de Saúde do Baixo Alentejo, EPE",281,577,858,2023,10,"-7.8721227,38.014123",4
2023-10-01,Região de Saúde do Centro,"Centro Hospitalar de Leiria, EPE",254,253,507,2023,10,"-8.7982706,39.7414812",2
2023-10-01,Região de Saúde do Centro,"Unidade Local de Saúde de Castelo Branco, EPE",2776,4395,7171,2023,10,"-7.4981271,39.8212263",2
2023-10-01,Região de Saúde LVT,"Centro Hospitalar de Lisboa Ocidental, EPE",216,2153,2369,2023,10,"-9.216985,38.708454",3
2023-10-01,Região de Saúde LVT,"Centro Hospitalar de Setúbal, EPE",152,443,595,2023,10,"-8.8818638,38.5283754",3
2023-10-01,Região de Saúde LVT,"Centro Hospitalar do Oeste, EPE, EPE",4174,7780,11954,2023,10,"-9.1258493,39.4054629",3
2023-10-01,Região de Saúde LVT,"Hospital de Vila Franca de Xira, EPE",180,0,180,2023,10,"-8.984506,38.977235",3
2023-10-01,Região de Saúde LVT,"Hospital Professor Doutor Fernando Fonseca, EPE",2661,21523,24184,2023,10,"-9.2264834,38.7422257",3
2023-10-01,Região de Saúde Norte,"Hospital da Senhora da Oliveira, Guimarães, EPE",956,0,956,2023,10,"-8.3086907,41.4387173",1
2023-10-01,Região de Saúde Norte,"Unidade Local de Saúde de Matosinhos, EPE",0,6669,6669,2023,10,"-8.6745115,41.1794456",1
2023-10-01,Região de Saúde Norte,"Unidade Local de Saúde do Alto Minho, EPE",3,70,73,2023,10,"-8.8252713,41.7056054",1
2023-11-01,Região de Saúde do Centro,"Centro Hospitalar e Universitário de Coimbra, EPE",6499,3265,9764,2023,11,"-8.4098211,40.2191523",2
2023-11-01,Região de Saúde do Centro,"Centro Hospitalar Tondela-Viseu, EPE",426,116,542,2023,11,"-8.0827433,40.516364",2
2023-11-01,Região de Saúde LVT,"Centro Hospitalar Universitário de Lisboa Norte, EPE",6665,69,6734,2023,11,"-9.1616116,38.7500861",3
2023-11-01,Região de Saúde LVT,"Hospital de Vila Franca de Xira, EPE",197,0,197,2023,11,"-8.984506,38.977235",3
2023-11-01,Região de Saúde Norte,"Centro Hospitalar Universitário de São João, EPE",0,0,0,2023,11,"-8.6010558,41.1831056",1
2023-11-01,Região de Saúde Norte,"Centro Hospitalar Póvoa de Varzim/Vila do Conde, EPE",490,129,619,2023,11,"-8.7589945,41.3828711",1
2023-11-01,Região de Saúde Norte,"Hospital de Braga, EPE",521,0,521,2023,11,"-8.398982,41.56785",1
2023-11-01,Região de Saúde Norte,"Instituto Português Oncologia do Porto, EPE",147,158,305,2023,11,"-8.6062881,41.1785642",1
2023-11-01,Região de Saúde Norte,"Unidade Local de Saúde do Alto Minho, EPE",3,76,79,2023,11,"-8.8252713,41.7056054",1
2023-12-01,Região de Saúde do Centro,"Centro Hospitalar Tondela-Viseu, EPE",312,82,394,2023,12,"-8.0827433,40.516364",2
2023-12-01,Região de Saúde LVT,"Centro Hospitalar de Setúbal, EPE",167,695,862,2023,12,"-8.8818638,38.5283754",3
2023-12-01,Região de Saúde LVT,"Centro Hospitalar Médio Tejo, EPE",0,0,0,2023,12,"-8.5404429,39.478072",3
2023-12-01,Região de Saúde LVT,"Hospital de Vila Franca de Xira, EPE",222,0,222,2023,12,"-8.984506,38.977235",3
2023-12-01,Região de Saúde Norte,"Centro Hospitalar do Médio Ave, EPE",260,4786,5046,2023,12,"-8.4802503,41.3423984",1
2023-12-01,Região de Saúde Norte,"Centro Hospitalar Entre Douro e Vouga, EPE",270,372,642,2023,12,"-8.5458794,40.9293884",1
2023-12-01,Região de Saúde Norte,"Centro Hospitalar Póvoa de Varzim/Vila do Conde, EPE",529,161,690,2023,12,"-8.7589945,41.3828711",1
2013-01-01,Região de Saúde do Alentejo,"Hospital Espírito Santo de Évora, EPE",89,44,133,2013,1,"-7.9032848,38.5684861",4
2013-01-01,Região de Saúde do Alentejo,"Unidade Local de Saúde do Baixo Alentejo, EPE",0,1,1,2013,1,"-7.8721227,38.014123",4
2013-01-01,Região de Saúde do Algarve,"Centro Hospitalar Universitário do Algarve,EPE",54,14,68,2013,1,"-7.9281554,37.0238973",5
2013-01-01,Região de Saúde do Centro,"Unidade Local de Saúde de Castelo Branco, EPE",12,7,19,2013,1,"-7.4981271,39.8212263",2
2013-02-01,Região de Saúde do Centro,"Centro Hospitalar Universitário Cova da Beira, EPE",55,19,74,2013,2,"-7.4922407,40.2804158",2
2013-02-01,Região de Saúde do Centro,"Centro Hospitalar do Baixo Vouga, EPE",84,88,172,2013,2,"-8.6543716,40.6362453",2
2013-02-01,Região de Saúde do Centro,"Unidade Local de Saúde da Guarda, EPE",38,10,48,2013,2,"-7.2734793,40.5309916",2
2013-02-01,Região de Saúde do Centro,"Unidade Local de Saúde de Castelo Branco, EPE",25,14,39,2013,2,"-7.4981271,39.8212263",2
2013-02-01,Região de Saúde Norte,"Unidade Local de Saúde de Matosinhos, EPE",341,0,341,2013,2,"-8.6745115,41.1794456",1
2013-03-01,Região de Saúde do Centro,"Centro Hospitalar do Baixo Vouga, EPE",114,106,220,2013,3,"-8.6543716,40.6362453",2
2013-04-01,Região de Saúde do Alentejo,"Unidade Local de Saúde do Baixo Alentejo, EPE",12,8,20,2013,4,"-7.8721227,38.014123",4
2013-04-01,Região de Saúde do Algarve,"Centro Hospitalar Universitário do Algarve,EPE",210,46,256,2013,4,"-7.9281554,37.0238973",5
2013-04-01,Região de Saúde do Centro,"Centro Hospitalar e Universitário de Coimbra, EPE",475,361,836,2013,4,"-8.4098211,40.2191523",2
2013-04-01,Região de Saúde LVT,"Centro Hospitalar de Setúbal, EPE",0,0,0,2013,4,"-8.8818638,38.5283754",3
2013-04-01,Região de Saúde LVT,"Hospital Professor Doutor Fernando Fonseca, EPE",0,0,0,2013,4,"-9.2264834,38.7422257",3
2013-04-01,Região de Saúde Norte,"Unidade Local de Saúde de Matosinhos, EPE",478,0,478,2013,4,"-8.6745115,41.1794456",1
2013-05-01,Região de Saúde Norte,"Unidade Local de Saúde de Matosinhos, EPE",584,0,584,2013,5,"-8.6745115,41.1794456",1
2013-06-01,Região de Saúde do Alentejo,"Unidade Local de Saúde do Norte Alentejano, EPE",449,545,994,2013,6,"-7.4263845,39.3003425",4
2013-07-01,Região de Saúde do Alentejo,"Hospital Espírito Santo de Évora, EPE",645,340,985,2013,7,"-7.9032848,38.5684861",4
2013-07-01,Região de Saúde do Alentejo,"Unidade Local de Saúde do Baixo Alentejo, EPE",35,18,53,2013,7,"-7.8721227,38.014123",4
2013-07-01,Região de Saúde do Centro,"Centro Hospitalar Universitário Cova da Beira, EPE",162,82,244,2013,7,"-7.4922407,40.2804158",2
2013-07-01,Região de Saúde LVT,"Centro Hospitalar de Setúbal, EPE",0,0,0,2013,7,"-8.8818638,38.5283754",3
2013-07-01,Região de Saúde Norte,"Centro Hospitalar Trás-os-Montes e Alto Douro, EPE",335,0,335,2013,7,"-7.7515252,41.3031784",1
2013-08-01,Região de Saúde do Alentejo,"Unidade Local de Saúde do Baixo Alentejo, EPE",35,18,53,2013,8,"-7.8721227,38.014123",4
2013-08-01,Região de Saúde do Algarve,"Centro Hospitalar Universitário do Algarve,EPE",395,82,477,2013,8,"-7.9281554,37.0238973",5
2013-08-01,Região de Saúde do Centro,"Centro Hospitalar Universitário Cova da Beira, EPE",140,83,223,2013,8,"-7.4922407,40.2804158",2
2013-08-01,Região de Saúde do Centro,"Centro Hospitalar e Universitário de Coimbra, EPE",1340,967,2307,2013,8,"-8.4098211,40.2191523",2
2013-09-01,Região de Saúde do Algarve,"Centro Hospitalar Universitário do Algarve,EPE",494,95,589,2013,9,"-7.9281554,37.0238973",5
2013-09-01,Região de Saúde do Centro,"Centro Hospitalar Universitário Cova da Beira, EPE",181,130,311,2013,9,"-7.4922407,40.2804158",2
2013-10-01,Região de Saúde do Alentejo,"Unidade Local de Saúde do Baixo Alentejo, EPE",38,18,56,2013,10,"-7.8721227,38.014123",4
2013-10-01,Região de Saúde do Centro,"Centro Hospitalar e Universitário de Coimbra, EPE",1423,977,2400,2013,10,"-8.4098211,40.2191523",2
2013-10-01,Região de Saúde do Centro,"Centro Hospitalar Tondela-Viseu, EPE",249,218,467,2013,10,"-8.0827433,40.516364",2
2013-10-01,Região de Saúde LVT,"Hospital Professor Doutor Fernando Fonseca, EPE",0,0,0,2013,10,"-9.2264834,38.7422257",3
2013-11-01,Região de Saúde do Alentejo,"Unidade Local de Saúde do Baixo Alentejo, EPE",53,21,74,2013,11,"-7.8721227,38.014123",4
2013-11-01,Região de Saúde do Centro,"Centro Hospitalar e Universitário de Coimbra, EPE",1513,1052,2565,2013,11,"-8.4098211,40.2191523",2
2013-11-01,Região de Saúde Norte,"Centro Hospitalar Trás-os-Montes e Alto Douro, EPE",521,0,521,2013,11,"-7.7515252,41.3031784",1
2013-12-01,Região de Saúde do Alentejo,"Hospital Espírito Santo de Évora, EPE",1128,551,1679,2013,12,"-7.9032848,38.5684861",4
2013-12-01,Região de Saúde do Centro,"Centro Hospitalar do Baixo Vouga, EPE",511,505,1016,2013,12,"-8.6543716,40.6362453",2
2013-12-01,Região de Saúde do Centro,"Centro Hospitalar Tondela-Viseu, EPE",289,281,570,2013,12,"-8.0827433,40.516364",2
2013-12-01,Região de Saúde LVT,"Hospital Professor Doutor Fernando Fonseca, EPE",0,0,0,2013,12,"-9.2264834,38.7422257",3
2014-01-01,Região de Saúde do Centro,"Unidade Local de Saúde de Castelo Branco, EPE",25,11,36,2014,1,"-7.4981271,39.8212263",2
2014-01-01,Região de Saúde LVT,"Hospital Professor Doutor Fernando Fonseca, EPE",0,0,0,2014,1,"-9.2264834,38.7422257",3
2014-01-01,Região de Saúde Norte,"Centro Hospitalar Universitário do Porto, EPE",35,0,35,2014,1,"-8.6172617,41.1472498",1
2014-02-01,Região de Saúde do Algarve,"Centro Hospitalar Universitário do Algarve,EPE",173,17,190,2014,2,"-7.9281554,37.0238973",5
2014-02-01,Região de Saúde do Centro,"Centro Hospitalar do Baixo Vouga, EPE",112,99,211,2014,2,"-8.6543716,40.6362453",2
2014-02-01,Região de Saúde do Centro,"Centro Hospitalar e Universitário de Coimbra, EPE",327,219,546,2014,2,"-8.4098211,40.2191523",2
2014-02-01,Região de Saúde do Centro,"Centro Hospitalar Tondela-Viseu, EPE",52,52,104,2014,2,"-8.0827433,40.516364",2
2014-02-01,Região de Saúde LVT,"Centro Hospitalar de Setúbal, EPE",0,0,0,2014,2,"-8.8818638,38.5283754",3
2014-02-01,Região de Saúde Norte,"Centro Hospitalar Universitário do Porto, EPE",73,0,73,2014,2,"-8.6172617,41.1472498",1
2014-03-01,Região de Saúde do Centro,"Centro Hospitalar Tondela-Viseu, EPE",83,78,161,2014,3,"-8.0827433,40.516364",2
2014-03-01,Região de Saúde Norte,"Centro Hospitalar Trás-os-Montes e Alto Douro, EPE",154,0,154,2014,3,"-7.7515252,41.3031784",1
2014-04-01,Região de Saúde do Centro,"Centro Hospitalar Universitário Cova da Beira, EPE",104,66,170,2014,4,"-7.4922407,40.2804158",2
2014-04-01,Região de Saúde do Centro,"Centro Hospitalar Tondela-Viseu, EPE",105,105,210,2014,4,"-8.0827433,40.516364",2
2014-04-01,Região de Saúde LVT,"Centro Hospitalar do Oeste, EPE",1,5,6,2014,4,"-9.1258493,39.4054629",3
2014-05-01,Região de Saúde do Centro,"Centro Hospitalar do Baixo Vouga, EPE",233,241,474,2014,5,"-8.6543716,40.6362453",2
2014-05-01,Região de Saúde Norte,"Unidade Local de Saúde de Matosinhos, EPE",884,0,884,2014,5,"-8.6745115,41.1794456",1
2014-06-01,Região de Saúde LVT,"Centro Hospitalar do Oeste, EPE",1,7,8,2014,6,"-9.1258493,39.4054629",3
2014-07-01,Região de Saúde do Alentejo,"Unidade Local de Saúde do Baixo Alentejo, EPE",46,26,72,2014,7,"-7.8721227,38.014123",4
2014-07-01,Região de Saúde do Alentejo,"Unidade Local de Saúde do Norte Alentejano, EPE",411,677,1088,2014,7,"-7.4263845,39.3003425",4
2014-07-01,Região de Saúde do Algarve,"Centro Hospitalar Universitário do Algarve,EPE",571,56,627,2014,7,"-7.9281554,37.0238973",5
2014-07-01,Região de Saúde LVT,"Centro Hospitalar de Setúbal, EPE",0,0,0,2014,7,"-8.8818638,38.5283754",3
2014-07-01,Região de Saúde Norte,"Centro Hospitalar Universitário de São João, EPE",0,0,0,2014,7,"-8.6010558,41.1831056",1
2014-08-01,Região de Saúde do Alentejo,"Unidade Local de Saúde do Norte Alentejano, EPE",484,730,1214,2014,8,"-7.4263845,39.3003425",4
2014-08-01,Região de Saúde do Centro,"Centro Hospitalar do Baixo Vouga, EPE",320,339,659,2014,8,"-8.6543716,40.6362453",2
2014-08-01,Região de Saúde LVT,"Centro Hospitalar de Setúbal, EPE",0,0,0,2014,8,"-8.8818638,38.5283754",3
2014-09-01,Região de Saúde do Alentejo,"Unidade Local de Saúde do Norte Alentejano, EPE",508,786,1294,2014,9,"-7.4263845,39.3003425",4
2014-09-01,Região de Saúde do Algarve,"Centro Hospitalar Universitário do Algarve,EPE",709,71,780,2014,9,"-7.9281554,37.0238973",5
2014-09-01,Região de Saúde do Centro,"Centro Hospitalar Universitário Cova da Beira, EPE",223,120,343,2014,9,"-7.4922407,40.2804158",2
2014-09-01,Região de Saúde do Centro,"Centro Hospitalar e Universitário de Coimbra, EPE",1455,994,2449,2014,9,"-8.4098211,40.2191523",2
2014-09-01,Região de Saúde do Centro,"Unidade Local de Saúde da Guarda, EPE",154,29,183,2014,9,"-7.2734793,40.5309916",2
2014-09-01,Região de Saúde Norte,"Centro Hospitalar Trás-os-Montes e Alto Douro, EPE",396,0,396,2014,9,"-7.7515252,41.3031784",1
2014-10-01,Região de Saúde do Centro,"Centro Hospitalar Tondela-Viseu, EPE",254,237,491,2014,10,"-8.0827433,40.516364",2
2014-11-01,Região de Saúde do Centro,"Centro Hospitalar e Universitário de Coimbra, EPE",1801,1292,3093,2014,11,"-8.4098211,40.2191523",2
2014-11-01,Região de Saúde do Centro,"Centro Hospitalar Tondela-Viseu, EPE",272,252,524,2014,11,"-8.0827433,40.516364",2
2014-12-01,Região de Saúde do Alentejo,"Unidade Local de Saúde do Baixo Alentejo, EPE",63,41,104,2014,12,"-7.8721227,38.014123",4
2014-12-01,Região de Saúde Norte,"Centro Hospitalar Trás-os-Montes e Alto Douro, EPE",528,0,528,2014,12,"-7.7515252,41.3031784",1
2015-01-01,Região de Saúde do Alentejo,"Unidade Local de Saúde do Baixo Alentejo, EPE",7,1,8,2015,1,"-7.8721227,38.014123",4
2015-01-01,Região de Saúde do Centro,"Centro Hospitalar e Universitário de Coimbra, EPE",98,125,223,2015,1,"-8.4098211,40.2191523",2
2015-01-01,Região de Saúde do Centro,"Unidade Local de Saúde de Castelo Branco, EPE",18,9,27,2015,1,"-7.4981271,39.8212263",2
2015-01-01,Região de Saúde Norte,"Centro Hospitalar Universitário do Porto, EPE",47,0,47,2015,1,"-8.6172617,41.1472498",1
2015-02-01,Região de Saúde do Alentejo,"Hospital Espírito Santo de Évora, EPE",204,106,310,2015,2,"-7.9032848,38.5684861",4
2015-02-01,Região de Saúde do Algarve,"Centro Hospitalar Universitário do Algarve,EPE",217,15,232,2015,2,"-7.9281554,37.0238973",5
2015-03-01,Região de Saúde Norte,"Unidade Local de Saúde de Matosinhos, EPE",375,0,375,2015,3,"-8.6745115,41.1794456",1
2015-04-01,Região de Saúde do Alentejo,"Unidade Local de Saúde do Norte Alentejano, EPE",316,301,617,2015,4,"-7.4263845,39.3003425",4
2015-04-01,Região de Saúde do Algarve,"Centro Hospitalar Universitário do Algarve,EPE",404,41,445,2015,4,"-7.9281554,37.0238973",5
2015-04-01,Região de Saúde do Centro,"Centro Hospitalar Universitário Cova da Beira, EPE",111,32,143,2015,4,"-7.4922407,40.2804158",2
2015-04-01,Região de Saúde Norte,"Centro Hospitalar Trás-os-Montes e Alto Douro, EPE",127,0,127,2015,4,"-7.7515252,41.3031784",1
2015-05-01,Região de Saúde Norte,"Centro Hospitalar Universitário do Porto, EPE",157,0,157,2015,5,"-8.6172617,41.1472498",1
2015-06-01,Região de Saúde do Centro,"Centro Hospitalar do Baixo Vouga, EPE",272,303,575,2015,6,"-8.6543716,40.6362453",2
2015-06-01,Região de Saúde do Centro,"Centro Hospitalar e Universitário de Coimbra, EPE",1077,815,1892,2015,6,"-8.4098211,40.2191523",2
2015-07-01,Região de Saúde do Centro,"Centro Hospitalar Universitário Cova da Beira, EPE",176,69,245,2015,7,"-7.4922407,40.2804158",2
2015-08-01,Região de Saúde do Centro,"Centro Hospitalar do Baixo Vouga, EPE",347,371,718,2015,8,"-8.6543716,40.6362453",2
2015-09-01,Região de Saúde do Algarve,"Centro Hospitalar Universitário do Algarve,EPE",919,87,1006,2015,9,"-7.9281554,37.0238973",5
2015-09-01,Região de Saúde do Centro,"Centro Hospitalar do Baixo Vouga, EPE",373,445,818,2015,9,"-8.6543716,40.6362453",2
2015-09-01,Região de Saúde do Centro,"Unidade Local de Saúde de Castelo Branco, EPE",92,87,179,2015,9,"-7.4981271,39.8212263",2
2015-10-01,Região de Saúde do Centro,"Centro Hospitalar Universitário Cova da Beira, EPE",248,120,368,2015,10,"-7.4922407,40.2804158",2
2015-10-01,Região de Saúde do Centro,"Centro Hospitalar Tondela-Viseu, EPE",272,234,506,2015,10,"-8.0827433,40.516364",2
2015-10-01,Região de Saúde Norte,"Centro Hospitalar Trás-os-Montes e Alto Douro, EPE",337,0,337,2015,10,"-7.7515252,41.3031784",1
2015-11-01,Região de Saúde do Alentejo,"Hospital Espírito Santo de Évora, EPE",1057,505,1562,2015,11,"-7.9032848,38.5684861",4
2015-11-01,Região de Saúde do Alentejo,"Unidade Local de Saúde do Baixo Alentejo, EPE",73,45,118,2015,11,"-7.8721227,38.014123",4
2015-11-01,Região de Saúde do Centro,"Centro Hospitalar Universitário Cova da Beira, EPE",272,134,406,2015,11,"-7.4922407,40.2804158",2
2015-11-01,Região de Saúde LVT,"Centro Hospitalar de Setúbal, EPE",0,0,0,2015,11,"-8.8818638,38.5283754",3
2015-11-01,Região de Saúde Norte,"Unidade Local de Saúde de Matosinhos, EPE",1933,0,1933,2015,11,"-8.6745115,41.1794456",1
2015-12-01,Região de Saúde do Alentejo,"Unidade Local de Saúde do Norte Alentejano, EPE",839,871,1710,2015,12,"-7.4263845,39.3003425",4
2015-12-01,Região de Saúde do Centro,"Centro Hospitalar Universitário Cova da Beira, EPE",276,142,418,2015,12,"-7.4922407,40.2804158",2
2015-12-01,Região de Saúde Norte,"Centro Hospitalar Universitário do Porto, EPE",399,0,399,2015,12,"-8.6172617,41.1472498",1
2016-01-01,Região de Saúde do Alentejo,"Unidade Local de Saúde do Baixo Alentejo, EPE",4,2,6,2016,1,"-7.8721227,38.014123",4
2016-01-01,Região de Saúde do Algarve,"Centro Hospitalar Universitário do Algarve,EPE",138,18,156,2016,1,"-7.9281554,37.0238973",5
2016-01-01,Região de Saúde do Centro,"Centro Hospitalar e Universitário de Coimbra, EPE",161,109,270,2016,1,"-8.4098211,40.2191523",2
2016-01-01,Região de Saúde do Centro,"Unidade Local de Saúde de Castelo Branco, EPE",24,10,34,2016,1,"-7.4981271,39.8212263",2
2016-01-01,Região de Saúde LVT,"Centro Hospitalar de Setúbal, EPE",0,0,0,2016,1,"-8.8818638,38.5283754",3
2016-02-01,Região de Saúde do Centro,"Unidade Local de Saúde da Guarda, EPE",75,0,75,2016,2,"-7.2734793,40.5309916",2
2016-02-01,Região de Saúde Norte,"Centro Hospitalar Trás-os-Montes e Alto Douro, EPE",99,0,99,2016,2,"-7.7515252,41.3031784",1
2016-03-01,Região de Saúde do Centro,"Unidade Local de Saúde de Castelo Branco, EPE",63,29,92,2016,3,"-7.4981271,39.8212263",2
2016-03-01,Região de Saúde Norte,"Centro Hospitalar Trás-os-Montes e Alto Douro, EPE",155,0,155,2016,3,"-7.7515252,41.3031784",1
2016-04-01,Região de Saúde do Alentejo,"Hospital Espírito Santo de Évora, EPE",381,110,491,2016,4,"-7.9032848,38.5684861",4
2016-04-01,Região de Saúde do Alentejo,"Unidade Local de Saúde do Norte Alentejano, EPE",198,218,416,2016,4,"-7.4263845,39.3003425",4
2016-04-01,Região de Saúde do Centro,"Unidade Local de Saúde da Guarda, EPE",122,0,122,2016,4,"-7.2734793,40.5309916",2
2016-04-01,Região de Saúde do Centro,"Unidade Local de Saúde de Castelo Branco, EPE",76,33,109,2016,4,"-7.4981271,39.8212263",2
2016-04-01,Região de Saúde Norte,"Centro Hospitalar Universitário de São João, EPE",0,0,0,2016,4,"-8.6010558,41.1831056",1
2016-04-01,Região de Saúde Norte,"Centro Hospitalar Trás-os-Montes e Alto Douro, EPE",195,0,195,2016,4,"-7.7515252,41.3031784",1
2016-04-01,Região de Saúde Norte,"Unidade Local de Saúde de Matosinhos, EPE",676,0,676,2016,4,"-8.6745115,41.1794456",1
2016-05-01,Região de Saúde do Centro,"Centro Hospitalar Universitário Cova da Beira, EPE",88,73,161,2016,5,"-7.4922407,40.2804158",2
2016-05-01,Região de Saúde LVT,"Instituto Português Oncologia de Lisboa, EPE",1,0,1,2016,5,"-9.1634516,38.7396768",3
2016-06-01,Região de Saúde do Centro,"Centro Hospitalar do Baixo Vouga, EPE",295,286,581,2016,6,"-8.6543716,40.6362453",2
2016-06-01,Região de Saúde do Centro,"Unidade Local de Saúde de Castelo Branco, EPE",106,72,178,2016,6,"-7.4981271,39.8212263",2
2016-06-01,Região de Saúde LVT,"Centro Hospitalar Universitário Lisboa Central, EPE",0,0,0,2016,6,"-9.1371248,38.7166948",3
2016-06-01,Região de Saúde Norte,"Centro Hospitalar Universitário do Porto, EPE",370,0,370,2016,6,"-8.6172617,41.1472498",1
2016-07-01,Região de Saúde do Centro,"Centro Hospitalar Tondela-Viseu, EPE",151,111,262,2016,7,"-8.0827433,40.516364",2
2016-07-01,Região de Saúde LVT,"Hospital Garcia de Orta, EPE",1,0,1,2016,7,"-9.1822554,38.6658713",3
2016-07-01,Região de Saúde Norte,"Centro Hospitalar Universitário do Porto, EPE",477,0,477,2016,7,"-8.6172617,41.1472498",1
2016-08-01,Região de Saúde do Alentejo,"Unidade Local de Saúde do Baixo Alentejo, EPE",19,14,33,2016,8,"-7.8721227,38.014123",4
2016-08-01,Região de Saúde do Centro,"Centro Hospitalar do Baixo Vouga, EPE",359,320,679,2016,8,"-8.6543716,40.6362453",2
2016-08-01,Região de Saúde Norte,"Centro Hospitalar Universitário de São João, EPE",0,0,0,2016,8,"-8.6010558,41.1831056",1
2016-09-01,Região de Saúde do Alentejo,"Hospital Espírito Santo de Évora, EPE",809,237,1046,2016,9,"-7.9032848,38.5684861",4
2016-09-01,Região de Saúde do Alentejo,"Unidade Local de Saúde do Baixo Alentejo, EPE",21,17,38,2016,9,"-7.8721227,38.014123",4
2016-09-01,Região de Saúde do Alentejo,"Unidade Local de Saúde do Norte Alentejano, EPE",362,463,825,2016,9,"-7.4263845,39.3003425",4
2016-10-01,Região de Saúde do Alentejo,"Unidade Local de Saúde do Norte Alentejano, EPE",411,553,964,2016,10,"-7.4263845,39.3003425",4
2016-10-01,Região de Saúde do Centro,"Centro Hospitalar e Universitário de Coimbra, EPE",2282,1135,3417,2016,10,"-8.4098211,40.2191523",2
2016-10-01,Região de Saúde do Centro,"Unidade Local de Saúde de Castelo Branco, EPE",125,96,221,2016,10,"-7.4981271,39.8212263",2
2016-10-01,Região de Saúde Norte,"Centro Hospitalar Universitário de São João, EPE",0,0,0,2016,10,"-8.6010558,41.1831056",1
2016-11-01,Região de Saúde do Centro,"Centro Hospitalar Tondela-Viseu, EPE",251,179,430,2016,11,"-8.0827433,40.516364",2
2016-11-01,Região de Saúde do Centro,"Unidade Local de Saúde da Guarda, EPE",336,0,336,2016,11,"-7.2734793,40.5309916",2
2016-11-01,Região de Saúde LVT,"Instituto Português Oncologia de Lisboa, EPE",2,0,2,2016,11,"-9.1634516,38.7396768",3
2016-11-01,Região de Saúde Norte,"Centro Hospitalar Trás-os-Montes e Alto Douro, EPE",535,11,546,2016,11,"-7.7515252,41.3031784",1
2016-11-01,Região de Saúde Norte,"Unidade Local de Saúde de Matosinhos, EPE",1938,0,1938,2016,11,"-8.6745115,41.1794456",1
2016-12-01,Região de Saúde do Algarve,"Centro Hospitalar Universitário do Algarve,EPE",1551,117,1668,2016,12,"-7.9281554,37.0238973",5
2016-12-01,Região de Saúde LVT,"Centro Hospitalar de Setúbal, EPE",123,0,123,2016,12,"-8.8818638,38.5283754",3
2016-12-01,Região de Saúde LVT,"Instituto Português Oncologia de Lisboa, EPE",2,0,2,2016,12,"-9.1634516,38.7396768",3
2017-01-01,Região de Saúde do Alentejo,"Unidade Local de Saúde do Baixo Alentejo, EPE",0,0,0,2017,1,"-7.8721227,38.014123",4
2017-01-01,Região de Saúde do Alentejo,"Unidade Local de Saúde do Norte Alentejano, EPE",60,46,106,2017,1,"-7.4263845,39.3003425",4
2017-01-01,Região de Saúde do Centro,"Unidade Local de Saúde da Guarda, EPE",34,0,34,2017,1,"-7.2734793,40.5309916",2
2017-01-01,Região de Saúde LVT,"Hospital Garcia de Orta, EPE",13,0,13,2017,1,"-9.1822554,38.6658713",3
2017-02-01,Região de Saúde do Centro,Centro Medicina de Reabilitação da Região Centro Rovisco Pais,8,1,9,2017,2,"-8.7707806,40.297919",2
2017-02-01,Região de Saúde Norte,"Centro Hospitalar Universitário do Porto, EPE",206,0,206,2017,2,"-8.6172617,41.1472498",1
2017-03-01,Região de Saúde do Alentejo,"Unidade Local de Saúde do Norte Alentejano, EPE",194,141,335,2017,3,"-7.4263845,39.3003425",4
2017-03-01,Região de Saúde do Algarve,"Centro Hospitalar Universitário do Algarve,EPE",159,3,162,2017,3,"-7.9281554,37.0238973",5
2017-03-01,Região de Saúde do Centro,"Centro Hospitalar do Baixo Vouga, EPE",140,166,306,2017,3,"-8.6543716,40.6362453",2
2017-04-01,Região de Saúde do Alentejo,"Hospital Espírito Santo de Évora, EPE",278,114,392,2017,4,"-7.9032848,38.5684861",4
2017-04-01,Região de Saúde do Alentejo,"Unidade Local de Saúde do Norte Alentejano, EPE",243,193,436,2017,4,"-7.4263845,39.3003425",4
2017-04-01,Região de Saúde do Centro,"Unidade Local de Saúde de Castelo Branco, EPE",116,31,147,2017,4,"-7.4981271,39.8212263",2
2017-04-01,Região de Saúde Norte,"Unidade Local de Saúde de Matosinhos, EPE",742,4492,5234,2017,4,"-8.6745115,41.1794456",1
2017-05-01,Região de Saúde do Alentejo,"Unidade Local de Saúde do Baixo Alentejo, EPE",0,0,0,2017,5,"-7.8721227,38.014123",4
2017-05-01,Região de Saúde do Centro,"Unidade Local de Saúde de Castelo Branco, EPE",145,44,189,2017,5,"-7.4981271,39.8212263",2
2017-05-01,Região de Saúde LVT,"Centro Hospitalar Universitário Lisboa Central, EPE",8,4,12,2017,5,"-9.1371248,38.7166948",3
2017-05-01,Região de Saúde Norte,"Centro Hospitalar Universitário do Porto, EPE",553,0,553,2017,5,"-8.6172617,41.1472498",1
2017-05-01,Região de Saúde Norte,"Centro Hospitalar Trás-os-Montes e Alto Douro, EPE",193,1,194,2017,5,"-7.7515252,41.3031784",1
2017-06-01,Região de Saúde do Centro,"Centro Hospitalar do Baixo Vouga, EPE",277,276,553,2017,6,"-8.6543716,40.6362453",2
2017-07-01,Região de Saúde do Centro,"Unidade Local de Saúde da Guarda, EPE",244,0,244,2017,7,"-7.2734793,40.5309916",2
2017-07-01,Região de Saúde LVT,"Hospital Garcia de Orta, EPE",112,0,112,2017,7,"-9.1822554,38.6658713",3
2017-07-01,Região de Saúde Norte,"Centro Hospitalar Universitário do Porto, EPE",909,0,909,2017,7,"-8.6172617,41.1472498",1
2017-08-01,Região de Saúde do Centro,"Centro Hospitalar de Leiria, EPE",260,167,427,2017,8,"-8.7982706,39.7414812",2
2017-08-01,Região de Saúde Norte,"Centro Hospitalar Trás-os-Montes e Alto Douro, EPE",288,1,289,2017,8,"-7.7515252,41.3031784",1
2017-09-01,Região de Saúde do Algarve,"Centro Hospitalar Universitário do Algarve,EPE",388,5,393,2017,9,"-7.9281554,37.0238973",5
2017-09-01,Região de Saúde do Centro,"Centro Hospitalar do Baixo Vouga, EPE",385,390,775,2017,9,"-8.6543716,40.6362453",2
2017-09-01,Região de Saúde do Centro,"Centro Hospitalar e Universitário de Coimbra, EPE",1667,790,2457,2017,9,"-8.4098211,40.2191523",2
2017-09-01,Região de Saúde do Centro,Centro Medicina de Reabilitação da Região Centro Rovisco Pais,26,1,27,2017,9,"-8.7707806,40.297919",2
2017-09-01,Região de Saúde Norte,"Centro Hospitalar Trás-os-Montes e Alto Douro, EPE",334,1,335,2017,9,"-7.7515252,41.3031784",1
2017-10-01,Região de Saúde do Algarve,"Centro Hospitalar Universitário do Algarve,EPE",391,5,396,2017,10,"-7.9281554,37.0238973",5
2017-10-01,Região de Saúde do Centro,"Centro Hospitalar de Leiria, EPE",341,209,550,2017,10,"-8.7982706,39.7414812",2
2017-10-01,Região de Saúde LVT,"Hospital Garcia de Orta, EPE",219,1,220,2017,10,"-9.1822554,38.6658713",3
2017-10-01,Região de Saúde Norte,"Centro Hospitalar Universitário do Porto, EPE",1410,0,1410,2017,10,"-8.6172617,41.1472498",1
2017-11-01,Região de Saúde do Alentejo,"Unidade Local de Saúde do Norte Alentejano, EPE",607,603,1210,2017,11,"-7.4263845,39.3003425",4
2017-11-01,Região de Saúde do Centro,"Centro Hospitalar de Leiria, EPE",355,237,592,2017,11,"-8.7982706,39.7414812",2
2017-11-01,Região de Saúde do Centro,"Centro Hospitalar Tondela-Viseu, EPE",180,121,301,2017,11,"-8.0827433,40.516364",2
2017-12-01,Região de Saúde LVT,"Centro Hospitalar Universitário Lisboa Central, EPE",19,24,43,2017,12,"-9.1371248,38.7166948",3
2017-12-01,Região de Saúde Norte,"Unidade Local de Saúde de Matosinhos, EPE",2503,13217,15720,2017,12,"-8.6745115,41.1794456",1
2018-01-01,Região de Saúde do Alentejo,"Unidade Local de Saúde do Litoral Alentejano, EPE",0,0,0,2018,1,"-8.6956768,38.0162314",4
2018-01-01,Região de Saúde do Algarve,"Centro Hospitalar Universitário do Algarve,EPE",0,1,1,2018,1,"-7.9281554,37.0238973",5
2018-01-01,Região de Saúde do Centro,"Centro Hospitalar Universitário Cova da Beira, EPE",35,9,44,2018,1,"-7.4922407,40.2804158",2
2018-01-01,Região de Saúde do Centro,"Unidade Local de Saúde de Castelo Branco, EPE",32,14,46,2018,1,"-7.4981271,39.8212263",2
2018-01-01,Região de Saúde LVT,"Centro Hospitalar Universitário de Lisboa Norte, EPE",27,0,27,2018,1,"-9.1616116,38.7500861",3
2018-01-01,Região de Saúde LVT,"Hospital Garcia de Orta, EPE",55,0,55,2018,1,"-9.1822554,38.6658713",3
2018-01-01,Região de Saúde Norte,"Centro Hospitalar Universitário do Porto, EPE",157,0,157,2018,1,"-8.6172617,41.1472498",1
2018-02-01,Região de Saúde do Alentejo,"Unidade Local de Saúde do Baixo Alentejo, EPE",1,0,1,2018,2,"-7.8721227,38.014123",4
2018-02-01,Região de Saúde do Centro,Centro Medicina de Reabilitação da Região Centro Rovisco Pais,6,0,6,2018,2,"-8.7707806,40.297919",2
2018-03-01,Região de Saúde do Alentejo,"Unidade Local de Saúde do Litoral Alentejano, EPE",5,11,16,2018,3,"-8.6956768,38.0162314",4
2018-03-01,Região de Saúde do Algarve,"Centro Hospitalar Universitário do Algarve,EPE",5,2,7,2018,3,"-7.9281554,37.0238973",5
2018-03-01,Região de Saúde do Centro,"Centro Hospitalar do Baixo Vouga, EPE",42,64,106,2018,3,"-8.6543716,40.6362453",2
2018-03-01,Região de Saúde do Centro,"Unidade Local de Saúde da Guarda, EPE",103,0,103,2018,3,"-7.2734793,40.5309916",2
2018-03-01,Região de Saúde do Centro,"Unidade Local de Saúde de Castelo Branco, EPE",87,31,118,2018,3,"-7.4981271,39.8212263",2
2018-03-01,Região de Saúde LVT,"Centro Hospitalar Universitário de Lisboa Norte, EPE",97,0,97,2018,3,"-9.1616116,38.7500861",3
2018-03-01,Região de Saúde LVT,"Hospital Garcia de Orta, EPE",159,0,159,2018,3,"-9.1822554,38.6658713",3
2018-04-01,Região de Saúde do Alentejo,"Unidade Local de Saúde do Litoral Alentejano, EPE",5,17,22,2018,4,"-8.6956768,38.0162314",4
2018-04-01,Região de Saúde do Centro,"Centro Hospitalar Universitário Cova da Beira, EPE",152,50,202,2018,4,"-7.4922407,40.2804158",2
2018-04-01,Região de Saúde do Centro,"Centro Hospitalar e Universitário de Coimbra, EPE",565,219,784,2018,4,"-8.4098211,40.2191523",2
2018-04-01,Região de Saúde LVT,"Hospital Garcia de Orta, EPE",194,0,194,2018,4,"-9.1822554,38.6658713",3
2018-04-01,Região de Saúde Norte,"Centro Hospitalar Universitário do Porto, EPE",711,0,711,2018,4,"-8.6172617,41.1472498",1
2018-05-01,Região de Saúde do Alentejo,"Hospital Espírito Santo de Évora, EPE",416,179,595,2018,5,"-7.9032848,38.5684861",4
2018-05-01,Região de Saúde do Alentejo,"Unidade Local de Saúde do Baixo Alentejo, EPE",8,4,12,2018,5,"-7.8721227,38.014123",4
2018-05-01,Região de Saúde do Alentejo,"Unidade Local de Saúde do Litoral Alentejano, EPE",5,17,22,2018,5,"-8.6956768,38.0162314",4
2018-05-01,Região de Saúde do Alentejo,"Unidade Local de Saúde do Norte Alentejano, EPE",234,266,500,2018,5,"-7.4263845,39.3003425",4
2018-05-01,Região de Saúde do Centro,"Centro Hospitalar e Universitário de Coimbra, EPE",763,337,1100,2018,5,"-8.4098211,40.2191523",2
2018-05-01,Região de Saúde LVT,"Centro Hospitalar Universitário Lisboa Central, EPE",7,18,25,2018,5,"-9.1371248,38.7166948",3
2018-05-01,Região de Saúde LVT,"Centro Hospitalar Universitário de Lisboa Norte, EPE",179,0,179,2018,5,"-9.1616116,38.7500861",3
2018-06-01,Região de Saúde do Alentejo,"Unidade Local de Saúde do Baixo Alentejo, EPE",16,4,20,2018,6,"-7.8721227,38.014123",4
2018-06-01,Região de Saúde Norte,"Centro Hospitalar Universitário do Porto, EPE",1282,0,1282,2018,6,"-8.6172617,41.1472498",1
2018-07-01,Região de Saúde do Centro,"Centro Hospitalar e Universitário de Coimbra, EPE",1059,457,1516,2018,7,"-8.4098211,40.2191523",2
2018-07-01,Região de Saúde LVT,"Centro Hospitalar Universitário de Lisboa Norte, EPE",273,0,273,2018,7,"-9.1616116,38.7500861",3
2018-07-01,Região de Saúde LVT,"Hospital Garcia de Orta, EPE",342,0,342,2018,7,"-9.1822554,38.6658713",3
2018-07-01,Região de Saúde Norte,"Centro Hospitalar Entre Douro e Vouga, EPE",4,0,4,2018,7,"-8.5458794,40.9293884",1
2018-08-01,Região de Saúde do Centro,"Centro Hospitalar Tondela-Viseu, EPE",111,96,207,2018,8,"-8.0827433,40.516364",2
2018-08-01,Região de Saúde do Centro,"Unidade Local de Saúde da Guarda, EPE",444,0,444,2018,8,"-7.2734793,40.5309916",2
2018-08-01,Região de Saúde Norte,"Centro Hospitalar Entre Douro e Vouga, EPE",4,0,4,2018,8,"-8.5458794,40.9293884",1
2018-09-01,Região de Saúde Norte,"Centro Hospitalar Entre Douro e Vouga, EPE",4,0,4,2018,9,"-8.5458794,40.9293884",1
2018-09-01,Região de Saúde Norte,"Centro Hospitalar Trás-os-Montes e Alto Douro, EPE",234,0,234,2018,9,"-7.7515252,41.3031784",1
2018-10-01,Região de Saúde do Alentejo,"Unidade Local de Saúde do Norte Alentejano, EPE",599,424,1023,2018,10,"-7.4263845,39.3003425",4
2018-10-01,Região de Saúde do Centro,"Centro Hospitalar de Leiria, EPE",277,211,488,2018,10,"-8.7982706,39.7414812",2
2018-10-01,Região de Saúde do Centro,"Centro Hospitalar do Baixo Vouga, EPE",396,330,726,2018,10,"-8.6543716,40.6362453",2
2018-10-01,Região de Saúde do Centro,"Centro Hospitalar e Universitário de Coimbra, EPE",1606,760,2366,2018,10,"-8.4098211,40.2191523",2
2018-11-01,Região de Saúde do Alentejo,"Unidade Local de Saúde do Baixo Alentejo, EPE",44,24,68,2018,11,"-7.8721227,38.014123",4
2018-11-01,Região de Saúde do Alentejo,"Unidade Local de Saúde do Norte Alentejano, EPE",676,460,1136,2018,11,"-7.4263845,39.3003425",4
2018-11-01,Região de Saúde LVT,"Centro Hospitalar de Lisboa Ocidental, EPE",134,0,134,2018,11,"-9.216985,38.708454",3
2018-12-01,Região de Saúde do Algarve,"Centro Hospitalar Universitário do Algarve,EPE",17,8,25,2018,12,"-7.9281554,37.0238973",5
2018-12-01,Região de Saúde do Centro,Centro Medicina de Reabilitação da Região Centro Rovisco Pais,36,2,38,2018,12,"-8.7707806,40.297919",2
2018-12-01,Região de Saúde Norte,"Instituto Português Oncologia do Porto, EPE",106,74,180,2018,12,"-8.6062881,41.1785642",1
2018-12-01,Região de Saúde Norte,"Unidade Local de Saúde de Matosinhos, EPE",0,12412,12412,2018,12,"-8.6745115,41.1794456",1
2019-01-01,Região de Saúde do Alentejo,"Unidade Local de Saúde do Norte Alentejano, EPE",71,32,103,2019,1,"-7.4263845,39.3003425",4
2019-01-01,Região de Saúde LVT,"Hospital Garcia de Orta, EPE",0,0,0,2019,1,"-9.1822554,38.6658713",3
2019-02-01,Região de Saúde LVT,"Centro Hospitalar Universitário Lisboa Central, EPE",5,10,15,2019,2,"-9.1371248,38.7166948",3
2019-03-01,Região de Saúde do Algarve,"Centro Hospitalar Universitário do Algarve,EPE",0,0,0,2019,3,"-7.9281554,37.0238973",5
2019-03-01,Região de Saúde LVT,"Centro Hospitalar Universitário Lisboa Central, EPE",11,10,21,2019,3,"-9.1371248,38.7166948",3
2019-04-01,Região de Saúde do Alentejo,"Unidade Local de Saúde do Litoral Alentejano, EPE",7,9,16,2019,4,"-8.6956768,38.0162314",4
2019-04-01,Região de Saúde LVT,"Centro Hospitalar Universitário de Lisboa Norte, EPE",812,7,819,2019,4,"-9.1616116,38.7500861",3
2019-04-01,Região de Saúde Norte,"Centro Hospitalar Universitário do Porto, EPE",849,0,849,2019,4,"-8.6172617,41.1472498",1
2019-05-01,Região de Saúde do Alentejo,"Unidade Local de Saúde do Baixo Alentejo, EPE",22,30,52,2019,5,"-7.8721227,38.014123",4
2019-05-01,Região de Saúde do Alentejo,"Unidade Local de Saúde do Norte Alentejano, EPE",264,96,360,2019,5,"-7.4263845,39.3003425",4
2019-05-01,Região de Saúde do Centro,"Unidade Local de Saúde de Castelo Branco, EPE",137,67,204,2019,5,"-7.4981271,39.8212263",2
2019-05-01,Região de Saúde LVT,"Centro Hospitalar de Lisboa Ocidental, EPE",90,0,90,2019,5,"-9.216985,38.708454",3
2019-06-01,Região de Saúde do Alentejo,"Unidade Local de Saúde do Baixo Alentejo, EPE",25,31,56,2019,6,"-7.8721227,38.014123",4
2019-06-01,Região de Saúde LVT,"Centro Hospitalar de Lisboa Ocidental, EPE",106,0,106,2019,6,"-9.216985,38.708454",3
2019-06-01,Região de Saúde LVT,"Hospital Garcia de Orta, EPE",0,0,0,2019,6,"-9.1822554,38.6658713",3
2019-06-01,Região de Saúde Norte,"Centro Hospitalar Trás-os-Montes e Alto Douro, EPE",644,0,644,2019,6,"-7.7515252,41.3031784",1
2019-07-01,Região de Saúde LVT,"Centro Hospitalar de Lisboa Ocidental, EPE",130,0,130,2019,7,"-9.216985,38.708454",3
2019-07-01,Região de Saúde LVT,"Centro Hospitalar Universitário de Lisboa Norte, EPE",1744,10,1754,2019,7,"-9.1616116,38.7500861",3
2019-07-01,Região de Saúde Norte,"Centro Hospitalar Universitário do Porto, EPE",1383,0,1383,2019,7,"-8.6172617,41.1472498",1
2019-07-01,Região de Saúde Norte,"Instituto Português Oncologia do Porto, EPE",40,29,69,2019,7,"-8.6062881,41.1785642",1
2019-08-01,Região de Saúde do Alentejo,"Hospital Espírito Santo de Évora, EPE",907,427,1334,2019,8,"-7.9032848,38.5684861",4
2019-08-01,Região de Saúde do Centro,Centro Medicina de Reabilitação da Região Centro Rovisco Pais,5,0,5,2019,8,"-8.7707806,40.297919",2
2019-08-01,Região de Saúde LVT,"Centro Hospitalar Universitário Lisboa Central, EPE",23,21,44,2019,8,"-9.1371248,38.7166948",3
2019-09-01,Região de Saúde do Alentejo,"Unidade Local de Saúde do Litoral Alentejano, EPE",13,18,31,2019,9,"-8.6956768,38.0162314",4
2019-09-01,Região de Saúde do Centro,"Centro Hospitalar e Universitário de Coimbra, EPE",1823,548,2371,2019,9,"-8.4098211,40.2191523",2
2019-09-01,Região de Saúde do Centro,Centro Medicina de Reabilitação da Região Centro Rovisco Pais,5,0,5,2019,9,"-8.7707806,40.297919",2
2019-09-01,Região de Saúde Norte,"Centro Hospitalar Trás-os-Montes e Alto Douro, EPE",810,0,810,2019,9,"-7.7515252,41.3031784",1
2019-09-01,Região de Saúde Norte,"Hospital Santa Maria Maior, EPE",0,4,4,2019,9,"-8.6171561,41.5324234",1
2019-09-01,Região de Saúde Norte,"Instituto Português Oncologia do Porto, EPE",51,43,94,2019,9,"-8.6062881,41.1785642",1
2019-10-01,Região de Saúde do Alentejo,"Hospital Espírito Santo de Évora, EPE",1096,542,1638,2019,10,"-7.9032848,38.5684861",4
2019-10-01,Região de Saúde do Alentejo,"Unidade Local de Saúde do Baixo Alentejo, EPE",34,37,71,2019,10,"-7.8721227,38.014123",4
2019-10-01,Região de Saúde do Centro,"Centro Hospitalar do Baixo Vouga, EPE",582,371,953,2019,10,"-8.6543716,40.6362453",2
2019-10-01,Região de Saúde do Centro,"Unidade Local de Saúde de Castelo Branco, EPE",228,121,349,2019,10,"-7.4981271,39.8212263",2
2019-10-01,Região de Saúde LVT,"Centro Hospitalar Universitário Lisboa Central, EPE",25,23,48,2019,10,"-9.1371248,38.7166948",3
2019-10-01,Região de Saúde LVT,"Centro Hospitalar Universitário de Lisboa Norte, EPE",2873,30,2903,2019,10,"-9.1616116,38.7500861",3
2019-10-01,Região de Saúde Norte,"Centro Hospitalar Universitário do Porto, EPE",1954,0,1954,2019,10,"-8.6172617,41.1472498",1
2019-11-01,Região de Saúde do Alentejo,"Unidade Local de Saúde do Norte Alentejano, EPE",539,220,759,2019,11,"-7.4263845,39.3003425",4
2019-11-01,Região de Saúde LVT,"Centro Hospitalar Universitário Lisboa Central, EPE",25,23,48,2019,11,"-9.1371248,38.7166948",3
2019-11-01,Região de Saúde Norte,"Hospital Santa Maria Maior, EPE",0,4,4,2019,11,"-8.6171561,41.5324234",1
2019-12-01,Região de Saúde do Alentejo,"Unidade Local de Saúde do Baixo Alentejo, EPE",55,40,95,2019,12,"-7.8721227,38.014123",4
2019-12-01,Região de Saúde LVT,"Centro Hospitalar de Lisboa Ocidental, EPE",317,0,317,2019,12,"-9.216985,38.708454",3
2019-12-01,Região de Saúde LVT,"Centro Hospitalar Universitário de Lisboa Norte, EPE",3551,42,3593,2019,12,"-9.1616116,38.7500861",3
2020-01-01,Região de Saúde do Alentejo,"Unidade Local de Saúde do Litoral Alentejano, EPE",0,0,0,2020,1,"-8.6956768,38.0162314",4
2020-01-01,Região de Saúde LVT,"Centro Hospitalar Médio Tejo, EPE",0,4,4,2020,1,"-8.5404429,39.478072",3
2020-01-01,Região de Saúde Norte,"Centro Hospitalar Entre Douro e Vouga, EPE",0,0,0,2020,1,"-8.5458794,40.9293884",1
2020-02-01,Região de Saúde do Alentejo,"Unidade Local de Saúde do Litoral Alentejano, EPE",0,0,0,2020,2,"-8.6956768,38.0162314",4
2020-02-01,Região de Saúde LVT,"Centro Hospitalar de Lisboa Ocidental, EPE",47,0,47,2020,2,"-9.216985,38.708454",3
2020-02-01,Região de Saúde LVT,"Centro Hospitalar de Setúbal, EPE",0,0,0,2020,2,"-8.8818638,38.5283754",3
2020-02-01,Região de Saúde Norte,"Centro Hospitalar Universitário do Porto, EPE",401,0,401,2020,2,"-8.6172617,41.1472498",1
2020-03-01,Região de Saúde do Alentejo,"Hospital Espírito Santo de Évora, EPE",319,127,446,2020,3,"-7.9032848,38.5684861",4
2020-03-01,Região de Saúde do Alentejo,"Unidade Local de Saúde do Litoral Alentejano, EPE",0,0,0,2020,3,"-8.6956768,38.0162314",4
2020-03-01,Região de Saúde do Centro,"Centro Hospitalar e Universitário de Coimbra, EPE",569,194,763,2020,3,"-8.4098211,40.2191523",2
2020-03-01,Região de Saúde do Centro,"Centro Hospitalar Tondela-Viseu, EPE",74,9,83,2020,3,"-8.0827433,40.516364",2
2020-03-01,Região de Saúde do Centro,"Unidade Local de Saúde de Castelo Branco, EPE",76,38,114,2020,3,"-7.4981271,39.8212263",2
2020-03-01,Região de Saúde LVT,"Centro Hospitalar Universitário Lisboa Central, EPE",2,6,8,2020,3,"-9.1371248,38.7166948",3
2020-03-01,Região de Saúde LVT,"Centro Hospitalar Universitário de Lisboa Norte, EPE",795,47,842,2020,3,"-9.1616116,38.7500861",3
2020-03-01,Região de Saúde Norte,"Centro Hospitalar Vila Nova de Gaia/Espinho, EPE",245,0,245,2020,3,"-8.5972617,41.1094138",1
2020-03-01,Região de Saúde Norte,"Unidade Local de Saúde de Matosinhos, EPE",0,2561,2561,2020,3,"-8.6745115,41.1794456",1
2020-04-01,Região de Saúde do Algarve,"Centro Hospitalar Universitário do Algarve,EPE",0,0,0,2020,4,"-7.9281554,37.0238973",5
2020-04-01,Região de Saúde do Centro,Hospital Arcebispo João Crisóstomo,78,0,78,2020,4,"-8.5933462,40.3470015",2
2020-04-01,Região de Saúde LVT,"Centro Hospitalar de Setúbal, EPE",0,0,0,2020,4,"-8.8818638,38.5283754",3
2020-04-01,Região de Saúde LVT,Centro Hospitalar Psiquiátrico de Lisboa,59,2501,2560,2020,4,"-9.1460705,38.7569771",3
2020-04-01,Região de Saúde Norte,"Centro Hospitalar Universitário do Porto, EPE",617,0,617,2020,4,"-8.6172617,41.1472498",1
2020-04-01,Região de Saúde Norte,"Centro Hospitalar Trás-os-Montes e Alto Douro, EPE",296,2,298,2020,4,"-7.7515252,41.3031784",1
2020-04-01,Região de Saúde Norte,"Centro Hospitalar Vila Nova de Gaia/Espinho, EPE",384,0,384,2020,4,"-8.5972617,41.1094138",1
2020-04-01,Região de Saúde Norte,"Instituto Português Oncologia do Porto, EPE",43,21,64,2020,4,"-8.6062881,41.1785642",1
2020-05-01,Região de Saúde do Alentejo,"Unidade Local de Saúde do Litoral Alentejano, EPE",0,0,0,2020,5,"-8.6956768,38.0162314",4
2020-05-01,Região de Saúde LVT,"Centro Hospitalar Universitário de Lisboa Norte, EPE",992,51,1043,2020,5,"-9.1616116,38.7500861",3
2020-05-01,Região de Saúde Norte,"Centro Hospitalar Póvoa de Varzim/Vila do Conde, EPE",4,21,25,2020,5,"-8.7589945,41.3828711",1
2020-05-01,Região de Saúde Norte,"Centro Hospitalar Trás-os-Montes e Alto Douro, EPE",382,2,384,2020,5,"-7.7515252,41.3031784",1
2020-05-01,Região de Saúde Norte,"Centro Hospitalar Vila Nova de Gaia/Espinho, EPE",403,0,403,2020,5,"-8.5972617,41.1094138",1
2020-06-01,Região de Saúde LVT,"Centro Hospitalar Universitário de Lisboa Norte, EPE",1145,51,1196,2020,6,"-9.1616116,38.7500861",3
2020-06-01,Região de Saúde Norte,"Centro Hospitalar Vila Nova de Gaia/Espinho, EPE",555,0,555,2020,6,"-8.5972617,41.1094138",1
2020-06-01,Região de Saúde Norte,"Unidade Local de Saúde de Matosinhos, EPE",0,4779,4779,2020,6,"-8.6745115,41.1794456",1
2020-07-01,Região de Saúde do Alentejo,"Unidade Local de Saúde do Norte Alentejano, EPE",154,126,280,2020,7,"-7.4263845,39.3003425",4
2020-07-01,Região de Saúde do Centro,"Unidade Local de Saúde de Castelo Branco, EPE",95,55,150,2020,7,"-7.4981271,39.8212263",2
2020-07-01,Região de Saúde LVT,"Centro Hospitalar do Oeste, EPE, EPE",29,4,33,2020,7,"-9.1258493,39.4054629",3
2020-07-01,Região de Saúde Norte,"Centro Hospitalar Universitário de São João, EPE",0,0,0,2020,7,"-8.6010558,41.1831056",1
2020-07-01,Região de Saúde Norte,"Centro Hospitalar Entre Douro e Vouga, EPE",19,60,79,2020,7,"-8.5458794,40.9293884",1
2020-07-01,Região de Saúde Norte,"Centro Hospitalar Póvoa de Varzim/Vila do Conde, EPE",80,96,176,2020,7,"-8.7589945,41.3828711",1
2020-07-01,Região de Saúde Norte,"Centro Hospitalar Vila Nova de Gaia/Espinho, EPE",618,0,618,2020,7,"-8.5972617,41.1094138",1
2020-07-01,Região de Saúde Norte,"Unidade Local de Saúde de Matosinhos, EPE",0,5586,5586,2020,7,"-8.6745115,41.1794456",1
2020-08-01,Região de Saúde do Centro,"Centro Hospitalar do Baixo Vouga, EPE",180,215,395,2020,8,"-8.6543716,40.6362453",2
2020-08-01,Região de Saúde LVT,"Centro Hospitalar Universitário Lisboa Central, EPE",135,945,1080,2020,8,"-9.1371248,38.7166948",3
2020-08-01,Região de Saúde LVT,"Centro Hospitalar de Lisboa Ocidental, EPE",131,0,131,2020,8,"-9.216985,38.708454",3
2020-08-01,Região de Saúde LVT,"Centro Hospitalar do Oeste, EPE, EPE",34,6,40,2020,8,"-9.1258493,39.4054629",3
2020-08-01,Região de Saúde LVT,"Centro Hospitalar Médio Tejo, EPE",2,14,16,2020,8,"-8.5404429,39.478072",3
2020-08-01,Região de Saúde Norte,"Centro Hospitalar Trás-os-Montes e Alto Douro, EPE",492,2,494,2020,8,"-7.7515252,41.3031784",1
2020-09-01,Região de Saúde do Alentejo,"Unidade Local de Saúde do Norte Alentejano, EPE",190,149,339,2020,9,"-7.4263845,39.3003425",4
2020-09-01,Região de Saúde do Centro,"Centro Hospitalar Universitário Cova da Beira, EPE",207,57,264,2020,9,"-7.4922407,40.2804158",2
2020-09-01,Região de Saúde Norte,"Centro Hospitalar Universitário de São João, EPE",0,0,0,2020,9,"-8.6010558,41.1831056",1
2020-09-01,Região de Saúde Norte,"Centro Hospitalar Entre Douro e Vouga, EPE",19,62,81,2020,9,"-8.5458794,40.9293884",1
2020-09-01,Região de Saúde Norte,"Centro Hospitalar Póvoa de Varzim/Vila do Conde, EPE",190,175,365,2020,9,"-8.7589945,41.3828711",1
2020-09-01,Região de Saúde Norte,"Hospital de Braga, EPE",3574,0,3574,2020,9,"-8.398982,41.56785",1
2020-09-01,Região de Saúde Norte,"Unidade Local de Saúde de Matosinhos, EPE",0,6831,6831,2020,9,"-8.6745115,41.1794456",1
2020-10-01,Região de Saúde do Centro,"Centro Hospitalar e Universitário de Coimbra, EPE",1843,581,2424,2020,10,"-8.4098211,40.2191523",2
2020-10-01,Região de Saúde do Centro,Hospital Arcebispo João Crisóstomo,107,0,107,2020,10,"-8.5933462,40.3470015",2
2020-10-01,Região de Saúde do Centro,"Unidade Local de Saúde de Castelo Branco, EPE",121,85,206,2020,10,"-7.4981271,39.8212263",2
2020-10-01,Região de Saúde LVT,"Centro Hospitalar Universitário de Lisboa Norte, EPE",1905,57,1962,2020,10,"-9.1616116,38.7500861",3
2020-10-01,Região de Saúde LVT,"Hospital Distrital de Santarém, EPE",0,6,6,2020,10,"-8.6937515,39.2410946",3
2020-10-01,Região de Saúde Norte,"Centro Hospitalar Universitário de São João, EPE",0,0,0,2020,10,"-8.6010558,41.1831056",1
2020-10-01,Região de Saúde Norte,"Centro Hospitalar Entre Douro e Vouga, EPE",19,63,82,2020,10,"-8.5458794,40.9293884",1
2020-10-01,Região de Saúde Norte,"Centro Hospitalar Vila Nova de Gaia/Espinho, EPE",898,0,898,2020,10,"-8.5972617,41.1094138",1
2020-11-01,Região de Saúde do Alentejo,"Hospital Espírito Santo de Évora, EPE",1380,241,1621,2020,11,"-7.9032848,38.5684861",4
2020-11-01,Região de Saúde do Alentejo,"Unidade Local de Saúde do Norte Alentejano, EPE",243,195,438,2020,11,"-7.4263845,39.3003425",4
2020-11-01,Região de Saúde LVT,"Hospital Distrital de Santarém, EPE",0,28,28,2020,11,"-8.6937515,39.2410946",3
2020-11-01,Região de Saúde Norte,"Centro Hospitalar Universitário de São João, EPE",0,0,0,2020,11,"-8.6010558,41.1831056",1
2020-11-01,Região de Saúde Norte,"Centro Hospitalar Universitário do Porto, EPE",1643,0,1643,2020,11,"-8.6172617,41.1472498",1
2020-11-01,Região de Saúde Norte,"Centro Hospitalar Entre Douro e Vouga, EPE",30,75,105,2020,11,"-8.5458794,40.9293884",1
2020-11-01,Região de Saúde Norte,"Centro Hospitalar Trás-os-Montes e Alto Douro, EPE",617,2,619,2020,11,"-7.7515252,41.3031784",1
2020-12-01,Região de Saúde do Algarve,"Centro Hospitalar Universitário do Algarve,EPE",0,0,0,2020,12,"-7.9281554,37.0238973",5
2020-12-01,Região de Saúde do Centro,"Centro Hospitalar Universitário Cova da Beira, EPE",253,70,323,2020,12,"-7.4922407,40.2804158",2
2020-12-01,Região de Saúde do Centro,"Centro Hospitalar do Baixo Vouga, EPE",351,409,760,2020,12,"-8.6543716,40.6362453",2
2020-12-01,Região de Saúde do Centro,"Centro Hospitalar e Universitário de Coimbra, EPE",2209,713,2922,2020,12,"-8.4098211,40.2191523",2
2020-12-01,Região de Saúde do Centro,"Centro Hospitalar Tondela-Viseu, EPE",245,44,289,2020,12,"-8.0827433,40.516364",2
2020-12-01,Região de Saúde LVT,"Centro Hospitalar de Lisboa Ocidental, EPE",188,0,188,2020,12,"-9.216985,38.708454",3
2020-12-01,Região de Saúde LVT,"Centro Hospitalar de Setúbal, EPE",0,0,0,2020,12,"-8.8818638,38.5283754",3
2020-12-01,Região de Saúde LVT,"Centro Hospitalar Universitário de Lisboa Norte, EPE",2282,59,2341,2020,12,"-9.1616116,38.7500861",3
2021-01-01,Região de Saúde do Centro,"Centro Hospitalar e Universitário de Coimbra, EPE",2503,17244,19747,2021,1,"-8.4098211,40.2191523",2
2021-01-01,Região de Saúde do Centro,Hospital Arcebispo João Crisóstomo,6,0,6,2021,1,"-8.5933462,40.3470015",2
2021-01-01,Região de Saúde Norte,"Centro Hospitalar Universitário de São João, EPE",0,0,0,2021,1,"-8.6010558,41.1831056",1
2021-02-01,Região de Saúde do Centro,"Centro Hospitalar do Baixo Vouga, EPE",68,72,140,2021,2,"-8.6543716,40.6362453",2
2021-02-01,Região de Saúde do Centro,Hospital Arcebispo João Crisóstomo,12,0,12,2021,2,"-8.5933462,40.3470015",2
2021-02-01,Região de Saúde LVT,"Centro Hospitalar de Setúbal, EPE",125,97,222,2021,2,"-8.8818638,38.5283754",3
2021-02-01,Região de Saúde LVT,Centro Hospitalar Psiquiátrico de Lisboa,77,1698,1775,2021,2,"-9.1460705,38.7569771",3
2021-02-01,Região de Saúde LVT,"Hospital Garcia de Orta, EPE",0,1,1,2021,2,"-9.1822554,38.6658713",3
2021-02-01,Região de Saúde Norte,"Centro Hospitalar Universitário do Porto, EPE",254,0,254,2021,2,"-8.6172617,41.1472498",1
2021-02-01,Região de Saúde Norte,"Centro Hospitalar Vila Nova de Gaia/Espinho, EPE",187,0,187,2021,2,"-8.5972617,41.1094138",1
2021-02-01,Região de Saúde Norte,"Hospital de Braga, EPE",39,0,39,2021,2,"-8.398982,41.56785",1
2021-02-01,Região de Saúde Norte,"Unidade Local de Saúde de Matosinhos, EPE",0,1603,1603,2021,2,"-8.6745115,41.1794456",1
2021-03-01,Região de Saúde do Alentejo,"Hospital Espírito Santo de Évora, EPE",286,39,325,2021,3,"-7.9032848,38.5684861",4
2021-03-01,Região de Saúde do Centro,"Centro Hospitalar Tondela-Viseu, EPE",60,21,81,2021,3,"-8.0827433,40.516364",2
2021-03-01,Região de Saúde do Centro,"Unidade Local de Saúde de Castelo Branco, EPE",101,73,174,2021,3,"-7.4981271,39.8212263",2
2021-03-01,Região de Saúde LVT,"Centro Hospitalar Universitário de Lisboa Norte, EPE",654,94,748,2021,3,"-9.1616116,38.7500861",3
2021-03-01,Região de Saúde Norte,"Centro Hospitalar Universitário de São João, EPE",0,0,0,2021,3,"-8.6010558,41.1831056",1
2021-03-01,Região de Saúde Norte,"Centro Hospitalar Póvoa de Varzim/Vila do Conde, EPE",175,153,328,2021,3,"-8.7589945,41.3828711",1
2021-04-01,Região de Saúde do Alentejo,"Unidade Local de Saúde do Norte Alentejano, EPE",74,57,131,2021,4,"-7.4263845,39.3003425",4
2021-04-01,Região de Saúde do Centro,"Centro Hospitalar Universitário Cova da Beira, EPE",4074,11511,15585,2021,4,"-7.4922407,40.2804158",2
2021-04-01,Região de Saúde LVT,"Centro Hospitalar do Oeste, EPE, EPE",3002,14691,17693,2021,4,"-9.1258493,39.4054629",3
2021-04-01,Região de Saúde LVT,"Hospital Distrital de Santarém, EPE",0,0,0,2021,4,"-8.6937515,39.2410946",3
2021-04-01,Região de Saúde Norte,"Hospital da Senhora da Oliveira, Guimarães, EPE",462,0,462,2021,4,"-8.3086907,41.4387173",1
2021-04-01,Região de Saúde Norte,"Hospital de Magalhães Lemos, EPE",0,2200,2200,2021,4,"-8.6649823,41.1764649",1
2021-04-01,Região de Saúde Norte,"Unidade Local de Saúde do Alto Minho, EPE",1,1,2,2021,4,"-8.8252713,41.7056054",1
2021-05-01,Região de Saúde do Alentejo,"Hospital Espírito Santo de Évora, EPE",485,71,556,2021,5,"-7.9032848,38.5684861",4
2021-05-01,Região de Saúde do Centro,"Centro Hospitalar do Baixo Vouga, EPE",184,166,350,2021,5,"-8.6543716,40.6362453",2
2021-05-01,Região de Saúde do Centro,"Centro Hospitalar Tondela-Viseu, EPE",97,35,132,2021,5,"-8.0827433,40.516364",2
2021-05-01,Região de Saúde LVT,"Centro Hospitalar Universitário Lisboa Central, EPE",2704,1296,4000,2021,5,"-9.1371248,38.7166948",3
2021-05-01,Região de Saúde LVT,"Hospital Distrital de Santarém, EPE",0,32,32,2021,5,"-8.6937515,39.2410946",3
2021-06-01,Região de Saúde do Centro,"Centro Hospitalar Universitário Cova da Beira, EPE",5326,14104,19430,2021,6,"-7.4922407,40.2804158",2
2021-06-01,Região de Saúde do Centro,"Centro Hospitalar do Baixo Vouga, EPE",226,189,415,2021,6,"-8.6543716,40.6362453",2
2021-06-01,Região de Saúde do Centro,"Centro Hospitalar Tondela-Viseu, EPE",112,42,154,2021,6,"-8.0827433,40.516364",2
2021-06-01,Região de Saúde do Centro,Hospital Arcebispo João Crisóstomo,60,0,60,2021,6,"-8.5933462,40.3470015",2
2021-06-01,Região de Saúde do Centro,"Unidade Local de Saúde de Castelo Branco, EPE",127,103,230,2021,6,"-7.4981271,39.8212263",2
2021-06-01,Região de Saúde LVT,"Centro Hospitalar de Lisboa Ocidental, EPE",78,0,78,2021,6,"-9.216985,38.708454",3
2021-06-01,Região de Saúde Norte,"Hospital de Braga, EPE",274,0,274,2021,6,"-8.398982,41.56785",1
2021-07-01,Região de Saúde do Alentejo,"Unidade Local de Saúde do Norte Alentejano, EPE",142,101,243,2021,7,"-7.4263845,39.3003425",4
2021-07-01,Região de Saúde do Centro,"Centro Hospitalar Universitário Cova da Beira, EPE",6246,15934,22180,2021,7,"-7.4922407,40.2804158",2
2021-07-01,Região de Saúde do Centro,"Centro Hospitalar de Leiria, EPE",193,137,330,2021,7,"-8.7982706,39.7414812",2
2021-07-01,Região de Saúde LVT,"Centro Hospitalar Universitário Lisboa Central, EPE",3708,1540,5248,2021,7,"-9.1371248,38.7166948",3
2021-07-01,Região de Saúde LVT,Centro Hospitalar Psiquiátrico de Lisboa,326,5454,5780,2021,7,"-9.1460705,38.7569771",3
2021-07-01,Região de Saúde LVT,"Hospital Garcia de Orta, EPE",24,3,27,2021,7,"-9.1822554,38.6658713",3
2021-07-01,Região de Saúde Norte,"Centro Hospitalar Vila Nova de Gaia/Espinho, EPE",605,0,605,2021,7,"-8.5972617,41.1094138",1
2021-07-01,Região de Saúde Norte,"Hospital da Senhora da Oliveira, Guimarães, EPE",721,0,721,2021,7,"-8.3086907,41.4387173",1
2021-08-01,Região de Saúde do Alentejo,"Unidade Local de Saúde do Baixo Alentejo, EPE",1098,1117,2215,2021,8,"-7.8721227,38.014123",4
2021-08-01,Região de Saúde do Centro,"Centro Hospitalar Tondela-Viseu, EPE",161,51,212,2021,8,"-8.0827433,40.516364",2
2021-08-01,Região de Saúde do Centro,"Hospital Distrital da Figueira da Foz, EPE",2736,6009,8745,2021,8,"-8.8586755,40.117897",2
2021-08-01,Região de Saúde Norte,"Hospital da Senhora da Oliveira, Guimarães, EPE",796,0,796,2021,8,"-8.3086907,41.4387173",1
2021-08-01,Região de Saúde Norte,"Unidade Local de Saúde do Alto Minho, EPE",5,1,6,2021,8,"-8.8252713,41.7056054",1
2021-09-01,Região de Saúde do Alentejo,"Unidade Local de Saúde do Litoral Alentejano, EPE",11,0,11,2021,9,"-8.6956768,38.0162314",4
2021-09-01,Região de Saúde do Alentejo,"Unidade Local de Saúde do Norte Alentejano, EPE",183,115,298,2021,9,"-7.4263845,39.3003425",4
2021-09-01,Região de Saúde do Algarve,"Centro Hospitalar Universitário do Algarve,EPE",0,0,0,2021,9,"-7.9281554,37.0238973",5
2021-09-01,Região de Saúde do Centro,"Centro Hospitalar Universitário Cova da Beira, EPE",7696,19036,26732,2021,9,"-7.4922407,40.2804158",2
2021-09-01,Região de Saúde do Centro,"Centro Hospitalar e Universitário de Coimbra, EPE",24681,99231,123912,2021,9,"-8.4098211,40.2191523",2
2021-09-01,Região de Saúde do Centro,"Unidade Local de Saúde de Castelo Branco, EPE",137,121,258,2021,9,"-7.4981271,39.8212263",2
2021-09-01,Região de Saúde LVT,"Centro Hospitalar de Lisboa Ocidental, EPE",124,0,124,2021,9,"-9.216985,38.708454",3
2021-09-01,Região de Saúde LVT,Centro Hospitalar Psiquiátrico de Lisboa,416,6847,7263,2021,9,"-9.1460705,38.7569771",3
2021-09-01,Região de Saúde Norte,"Hospital de Braga, EPE",433,0,433,2021,9,"-8.398982,41.56785",1
2021-10-01,Região de Saúde do Centro,"Centro Hospitalar e Universitário de Coimbra, EPE",26778,105354,132132,2021,10,"-8.4098211,40.2191523",2
2021-10-01,Região de Saúde do Centro,Hospital Arcebispo João Crisóstomo,88,0,88,2021,10,"-8.5933462,40.3470015",2
2021-10-01,Região de Saúde do Centro,"Hospital Distrital da Figueira da Foz, EPE",3066,6633,9699,2021,10,"-8.8586755,40.117897",2
2021-10-01,Região de Saúde LVT,"Centro Hospitalar Universitário de Lisboa Norte, EPE",3629,762,4391,2021,10,"-9.1616116,38.7500861",3
2021-10-01,Região de Saúde LVT,"Hospital Professor Doutor Fernando Fonseca, EPE",5,99,104,2021,10,"-9.2264834,38.7422257",3
2021-10-01,Região de Saúde Norte,"Centro Hospitalar Entre Douro e Vouga, EPE",61,22,83,2021,10,"-8.5458794,40.9293884",1
2021-11-01,Região de Saúde do Alentejo,"Unidade Local de Saúde do Baixo Alentejo, EPE",1389,1379,2768,2021,11,"-7.8721227,38.014123",4
2021-11-01,Região de Saúde do Centro,"Centro Hospitalar do Baixo Vouga, EPE",358,351,709,2021,11,"-8.6543716,40.6362453",2
2021-11-01,Região de Saúde LVT,"Centro Hospitalar Médio Tejo, EPE",0,0,0,2021,11,"-8.5404429,39.478072",3
2021-11-01,Região de Saúde LVT,"Hospital Garcia de Orta, EPE",1037,10518,11555,2021,11,"-9.1822554,38.6658713",3
2021-11-01,Região de Saúde Norte,"Centro Hospitalar do Médio Ave, EPE",135,2528,2663,2021,11,"-8.4802503,41.3423984",1
2021-11-01,Região de Saúde Norte,"Centro Hospitalar Póvoa de Varzim/Vila do Conde, EPE",441,342,783,2021,11,"-8.7589945,41.3828711",1
2021-11-01,Região de Saúde Norte,"Instituto Português Oncologia do Porto, EPE",92,89,181,2021,11,"-8.6062881,41.1785642",1
2021-12-01,Região de Saúde do Centro,"Centro Hospitalar do Baixo Vouga, EPE",382,391,773,2021,12,"-8.6543716,40.6362453",2
2021-12-01,Região de Saúde do Centro,"Hospital Distrital da Figueira da Foz, EPE",3562,7713,11275,2021,12,"-8.8586755,40.117897",2
2021-12-01,Região de Saúde LVT,"Centro Hospitalar de Lisboa Ocidental, EPE",181,0,181,2021,12,"-9.216985,38.708454",3
2021-12-01,Região de Saúde Norte,"Centro Hospitalar Póvoa de Varzim/Vila do Conde, EPE",441,380,821,2021,12,"-8.7589945,41.3828711",1
2021-12-01,Região de Saúde Norte,"Centro Hospitalar Trás-os-Montes e Alto Douro, EPE",295,1,296,2021,12,"-7.7515252,41.3031784",1
2021-12-01,Região de Saúde Norte,"Hospital de Braga, EPE",603,0,603,2021,12,"-8.398982,41.56785",1
2021-12-01,Região de Saúde Norte,"Hospital de Magalhães Lemos, EPE",0,4780,4780,2021,12,"-8.6649823,41.1764649",1
2021-12-01,Região de Saúde Norte,"Unidade Local de Saúde de Matosinhos, EPE",0,9122,9122,2021,12,"-8.6745115,41.1794456",1
2022-01-01,Região de Saúde do Alentejo,"Hospital Espírito Santo de Évora, EPE",98,14,112,2022,1,"-7.9032848,38.5684861",4
2022-01-01,Região de Saúde do Algarve,"Centro Hospitalar Universitário do Algarve,EPE",0,0,0,2022,1,"-7.9281554,37.0238973",5
2022-01-01,Região de Saúde do Centro,"Hospital Distrital da Figueira da Foz, EPE",328,502,830,2022,1,"-8.8586755,40.117897",2
2022-01-01,Região de Saúde Norte,"Centro Hospitalar Vila Nova de Gaia/Espinho, EPE",59,0,59,2022,1,"-8.5972617,41.1094138",1
2022-02-01,Região de Saúde do Centro,"Centro Hospitalar de Leiria, EPE",52,36,88,2022,2,"-8.7982706,39.7414812",2
2022-02-01,Região de Saúde do Centro,Centro Medicina de Reabilitação da Região Centro Rovisco Pais,7,0,7,2022,2,"-8.7707806,40.297919",2
2022-02-01,Região de Saúde do Centro,"Unidade Local de Saúde de Castelo Branco, EPE",779,955,1734,2022,2,"-7.4981271,39.8212263",2
2022-02-01,Região de Saúde LVT,"Centro Hospitalar de Lisboa Ocidental, EPE",63,321,384,2022,2,"-9.216985,38.708454",3
2022-02-01,Região de Saúde Norte,"Centro Hospitalar Universitário do Porto, EPE",467,0,467,2022,2,"-8.6172617,41.1472498",1
2022-02-01,Região de Saúde Norte,"Centro Hospitalar Entre Douro e Vouga, EPE",57,36,93,2022,2,"-8.5458794,40.9293884",1
2022-02-01,Região de Saúde Norte,"Centro Hospitalar Trás-os-Montes e Alto Douro, EPE",38,0,38,2022,2,"-7.7515252,41.3031784",1
2022-03-01,Região de Saúde do Centro,"Centro Hospitalar de Leiria, EPE",78,60,138,2022,3,"-8.7982706,39.7414812",2
2022-03-01,Região de Saúde do Centro,Centro Medicina de Reabilitação da Região Centro Rovisco Pais,7,0,7,2022,3,"-8.7707806,40.297919",2
2022-03-01,Região de Saúde LVT,"Centro Hospitalar de Lisboa Ocidental, EPE",102,502,604,2022,3,"-9.216985,38.708454",3
2022-03-01,Região de Saúde LVT,"Hospital Distrital de Santarém, EPE",1,19,20,2022,3,"-8.6937515,39.2410946",3
2022-03-01,Região de Saúde Norte,"Centro Hospitalar do Médio Ave, EPE",45,1329,1374,2022,3,"-8.4802503,41.3423984",1
2022-03-01,Região de Saúde Norte,"Centro Hospitalar Póvoa de Varzim/Vila do Conde, EPE",115,6,121,2022,3,"-8.7589945,41.3828711",1
2022-03-01,Região de Saúde Norte,"Hospital de Magalhães Lemos, EPE",0,922,922,2022,3,"-8.6649823,41.1764649",1
2022-03-01,Região de Saúde Norte,"Instituto Português Oncologia do Porto, EPE",32,42,74,2022,3,"-8.6062881,41.1785642",1
2022-03-01,Região de Saúde Norte,"Unidade Local de Saúde de Matosinhos, EPE",0,2228,2228,2022,3,"-8.6745115,41.1794456",1
2022-03-01,Região de Saúde Norte,"Unidade Local de Saúde do Alto Minho, EPE",14,21,35,2022,3,"-8.8252713,41.7056054",1
2022-04-01,Região de Saúde do Centro,"Centro Hospitalar Universitário Cova da Beira, EPE",2327,5871,8198,2022,4,"-7.4922407,40.2804158",2
2022-04-01,Região de Saúde do Centro,"Hospital Distrital da Figueira da Foz, EPE",1002,1572,2574,2022,4,"-8.8586755,40.117897",2
2022-04-01,Região de Saúde LVT,"Centro Hospitalar do Oeste, EPE, EPE",3358,6656,10014,2022,4,"-9.1258493,39.4054629",3
2022-04-01,Região de Saúde LVT,Centro Hospitalar Psiquiátrico de Lisboa,187,2989,3176,2022,4,"-9.1460705,38.7569771",3
2022-04-01,Região de Saúde LVT,"Hospital de Vila Franca de Xira, EPE",144,4548,4692,2022,4,"-8.984506,38.977235",3
2022-04-01,Região de Saúde Norte,"Centro Hospitalar Vila Nova de Gaia/Espinho, EPE",212,0,212,2022,4,"-8.5972617,41.1094138",1
2022-04-01,Região de Saúde Norte,"Hospital da Senhora da Oliveira, Guimarães, EPE",431,0,431,2022,4,"-8.3086907,41.4387173",1
2022-05-01,Região de Saúde do Algarve,"Centro Hospitalar Universitário do Algarve,EPE",0,0,0,2022,5,"-7.9281554,37.0238973",5
2022-05-01,Região de Saúde do Centro,"Centro Hospitalar Universitário Cova da Beira, EPE",2973,7291,10264,2022,5,"-7.4922407,40.2804158",2
2022-05-01,Região de Saúde do Centro,"Centro Hospitalar do Baixo Vouga, EPE",226,177,403,2022,5,"-8.6543716,40.6362453",2
2022-05-01,Região de Saúde LVT,"Hospital de Vila Franca de Xira, EPE",166,5432,5598,2022,5,"-8.984506,38.977235",3
2022-05-01,Região de Saúde LVT,"Hospital Distrital de Santarém, EPE",1,37,38,2022,5,"-8.6937515,39.2410946",3
2022-05-01,Região de Saúde Norte,"Centro Hospitalar Trás-os-Montes e Alto Douro, EPE",127,0,127,2022,5,"-7.7515252,41.3031784",1
2022-05-01,Região de Saúde Norte,"Instituto Português Oncologia do Porto, EPE",55,79,134,2022,5,"-8.6062881,41.1785642",1
2022-06-01,Região de Saúde do Alentejo,"Unidade Local de Saúde do Litoral Alentejano, EPE",17,0,17,2022,6,"-8.6956768,38.0162314",4
2022-06-01,Região de Saúde do Centro,"Centro Hospitalar Universitário Cova da Beira, EPE",3502,8636,12138,2022,6,"-7.4922407,40.2804158",2
2022-06-01,Região de Saúde do Centro,"Centro Hospitalar do Baixo Vouga, EPE",272,222,494,2022,6,"-8.6543716,40.6362453",2
2022-06-01,Região de Saúde do Centro,"Centro Hospitalar Tondela-Viseu, EPE",147,66,213,2022,6,"-8.0827433,40.516364",2
2022-06-01,Região de Saúde do Centro,Hospital Arcebispo João Crisóstomo,36,0,36,2022,6,"-8.5933462,40.3470015",2
2022-06-01,Região de Saúde LVT,"Centro Hospitalar do Oeste, EPE, EPE",5361,10264,15625,2022,6,"-9.1258493,39.4054629",3
2022-06-01,Região de Saúde LVT,"Centro Hospitalar Universitário de Lisboa Norte, EPE",3176,399,3575,2022,6,"-9.1616116,38.7500861",3
2022-06-01,Região de Saúde Norte,"Centro Hospitalar Vila Nova de Gaia/Espinho, EPE",300,0,300,2022,6,"-8.5972617,41.1094138",1
2022-07-01,Região de Saúde do Centro,"Centro Hospitalar de Leiria, EPE",174,115,289,2022,7,"-8.7982706,39.7414812",2
2022-07-01,Região de Saúde do Centro,"Centro Hospitalar do Baixo Vouga, EPE",290,250,540,2022,7,"-8.6543716,40.6362453",2
2022-07-01,Região de Saúde do Centro,"Centro Hospitalar e Universitário de Coimbra, EPE",1523,1523,3046,2022,7,"-8.4098211,40.2191523",2
2022-07-01,Região de Saúde do Centro,"Centro Hospitalar Tondela-Viseu, EPE",171,71,242,2022,7,"-8.0827433,40.516364",2
2022-07-01,Região de Saúde do Centro,Hospital Arcebispo João Crisóstomo,42,0,42,2022,7,"-8.5933462,40.3470015",2
2022-07-01,Região de Saúde LVT,"Centro Hospitalar de Lisboa Ocidental, EPE",162,1149,1311,2022,7,"-9.216985,38.708454",3
2022-07-01,Região de Saúde LVT,"Hospital Garcia de Orta, EPE",1219,11333,12552,2022,7,"-9.1822554,38.6658713",3
2022-07-01,Região de Saúde Norte,"Centro Hospitalar do Médio Ave, EPE",127,2841,2968,2022,7,"-8.4802503,41.3423984",1
2022-07-01,Região de Saúde Norte,"Centro Hospitalar Trás-os-Montes e Alto Douro, EPE",156,0,156,2022,7,"-7.7515252,41.3031784",1
2022-08-01,Região de Saúde do Centro,Hospital Arcebispo João Crisóstomo,49,0,49,2022,8,"-8.5933462,40.3470015",2
2022-08-01,Região de Saúde LVT,"Centro Hospitalar do Oeste, EPE, EPE",6547,12022,18569,2022,8,"-9.1258493,39.4054629",3
2022-08-01,Região de Saúde LVT,"Centro Hospitalar Universitário de Lisboa Norte, EPE",4376,465,4841,2022,8,"-9.1616116,38.7500861",3
2022-08-01,Região de Saúde LVT,"Centro Hospitalar Médio Tejo, EPE",0,0,0,2022,8,"-8.5404429,39.478072",3
2022-08-01,Região de Saúde Norte,"Centro Hospitalar Universitário do Porto, EPE",2282,0,2282,2022,8,"-8.6172617,41.1472498",1
2022-08-01,Região de Saúde Norte,"Centro Hospitalar Trás-os-Montes e Alto Douro, EPE",186,0,186,2022,8,"-7.7515252,41.3031784",1
2022-08-01,Região de Saúde Norte,"Unidade Local de Saúde do Alto Minho, EPE",15,46,61,2022,8,"-8.8252713,41.7056054",1
2022-09-01,Região de Saúde do Centro,"Hospital Distrital da Figueira da Foz, EPE",1674,2784,4458,2022,9,"-8.8586755,40.117897",2
2022-09-01,Região de Saúde LVT,"Centro Hospitalar Universitário Lisboa Central, EPE",832,2716,3548,2022,9,"-9.1371248,38.7166948",3
2022-09-01,Região de Saúde LVT,"Centro Hospitalar de Setúbal, EPE",523,684,1207,2022,9,"-8.8818638,38.5283754",3
2022-09-01,Região de Saúde LVT,Centro Hospitalar Psiquiátrico de Lisboa,354,6289,6643,2022,9,"-9.1460705,38.7569771",3
2022-09-01,Região de Saúde Norte,"Centro Hospitalar Entre Douro e Vouga, EPE",75,86,161,2022,9,"-8.5458794,40.9293884",1
2022-09-01,Região de Saúde Norte,"Centro Hospitalar Trás-os-Montes e Alto Douro, EPE",197,0,197,2022,9,"-7.7515252,41.3031784",1
2022-09-01,Região de Saúde Norte,"Hospital da Senhora da Oliveira, Guimarães, EPE",760,0,760,2022,9,"-8.3086907,41.4387173",1
2022-09-01,Região de Saúde Norte,"Hospital de Magalhães Lemos, EPE",0,2232,2232,2022,9,"-8.6649823,41.1764649",1
2022-09-01,Região de Saúde Norte,"Unidade Local de Saúde do Alto Minho, EPE",15,50,65,2022,9,"-8.8252713,41.7056054",1
2022-10-01,Região de Saúde LVT,"Centro Hospitalar de Setúbal, EPE",544,730,1274,2022,10,"-8.8818638,38.5283754",3
2022-10-01,Região de Saúde LVT,"Hospital de Vila Franca de Xira, EPE",214,6827,7041,2022,10,"-8.984506,38.977235",3
2022-10-01,Região de Saúde Norte,"Centro Hospitalar Póvoa de Varzim/Vila do Conde, EPE",430,6,436,2022,10,"-8.7589945,41.3828711",1
2022-10-01,Região de Saúde Norte,"Centro Hospitalar Trás-os-Montes e Alto Douro, EPE",238,0,238,2022,10,"-7.7515252,41.3031784",1
2022-10-01,Região de Saúde Norte,"Unidade Local de Saúde do Alto Minho, EPE",15,64,79,2022,10,"-8.8252713,41.7056054",1
2022-11-01,Região de Saúde do Alentejo,"Hospital Espírito Santo de Évora, EPE",1227,209,1436,2022,11,"-7.9032848,38.5684861",4
2022-11-01,Região de Saúde do Alentejo,"Unidade Local de Saúde do Litoral Alentejano, EPE",23,0,23,2022,11,"-8.6956768,38.0162314",4
2022-11-01,Região de Saúde LVT,"Hospital Professor Doutor Fernando Fonseca, EPE",3557,31270,34827,2022,11,"-9.2264834,38.7422257",3
2022-11-01,Região de Saúde LVT,"Hospital Garcia de Orta, EPE",1639,16297,17936,2022,11,"-9.1822554,38.6658713",3
2022-11-01,Região de Saúde Norte,"Centro Hospitalar Entre Douro e Vouga, EPE",105,149,254,2022,11,"-8.5458794,40.9293884",1
2022-11-01,Região de Saúde Norte,"Instituto Português Oncologia do Porto, EPE",119,154,273,2022,11,"-8.6062881,41.1785642",1
2022-12-01,Região de Saúde do Alentejo,"Hospital Espírito Santo de Évora, EPE",1312,227,1539,2022,12,"-7.9032848,38.5684861",4
2022-12-01,Região de Saúde do Alentejo,"Unidade Local de Saúde do Baixo Alentejo, EPE",1531,909,2440,2022,12,"-7.8721227,38.014123",4
2022-12-01,Região de Saúde do Centro,"Centro Hospitalar Universitário Cova da Beira, EPE",5740,15528,21268,2022,12,"-7.4922407,40.2804158",2
2022-12-01,Região de Saúde do Centro,"Centro Hospitalar de Leiria, EPE",288,225,513,2022,12,"-8.7982706,39.7414812",2
2022-12-01,Região de Saúde do Centro,"Centro Hospitalar do Baixo Vouga, EPE",472,423,895,2022,12,"-8.6543716,40.6362453",2
2022-12-01,Região de Saúde do Centro,Hospital Arcebispo João Crisóstomo,59,0,59,2022,12,"-8.5933462,40.3470015",2
2022-12-01,Região de Saúde do Centro,"Unidade Local de Saúde de Castelo Branco, EPE",4456,5598,10054,2022,12,"-7.4981271,39.8212263",2
2022-12-01,Região de Saúde LVT,"Centro Hospitalar Barreiro/Montijo, EPE",1722,2607,4329,2022,12,"-9.0592392,38.6554005",3
2022-12-01,Região de Saúde LVT,"Centro Hospitalar Universitário Lisboa Central, EPE",1031,4001,5032,2022,12,"-9.1371248,38.7166948",3
2022-12-01,Região de Saúde LVT,"Centro Hospitalar de Lisboa Ocidental, EPE",266,1972,2238,2022,12,"-9.216985,38.708454",3
2022-12-01,Região de Saúde LVT,"Centro Hospitalar Universitário de Lisboa Norte, EPE",7017,530,7547,2022,12,"-9.1616116,38.7500861",3
2022-12-01,Região de Saúde LVT,"Hospital de Vila Franca de Xira, EPE",287,10148,10435,2022,12,"-8.984506,38.977235",3
2022-12-01,Região de Saúde Norte,"Hospital da Senhora da Oliveira, Guimarães, EPE",766,0,766,2022,12,"-8.3086907,41.4387173",1
2022-12-01,Região de Saúde Norte,"Unidade Local de Saúde do Alto Minho, EPE",16,105,121,2022,12,"-8.8252713,41.7056054",1
2023-01-01,Região de Saúde do Alentejo,"Unidade Local de Saúde do Baixo Alentejo, EPE",36,57,93,2023,1,"-7.8721227,38.014123",4
2023-01-01,Região de Saúde do Alentejo,"Unidade Local de Saúde do Norte Alentejano, EPE",17,111,128,2023,1,"-7.4263845,39.3003425",4
2023-01-01,Região de Saúde do Centro,"Centro Hospitalar Universitário Cova da Beira, EPE",416,1275,1691,2023,1,"-7.4922407,40.2804158",2
2023-01-01,Região de Saúde do Centro,Centro Medicina de Reabilitação da Região Centro Rovisco Pais,11,5,16,2023,1,"-8.7707806,40.297919",2
2023-01-01,Região de Saúde do Centro,"Instituto Português Oncologia de Coimbra, EPE",0,3,3,2023,1,"-8.4103814,40.2162514",2
2023-01-01,Região de Saúde LVT,"Hospital Professor Doutor Fernando Fonseca, EPE",285,2821,3106,2023,1,"-9.2264834,38.7422257",3
2023-01-01,Região de Saúde Norte,"Centro Hospitalar Vila Nova de Gaia/Espinho, EPE",36,0,36,2023,1,"-8.5972617,41.1094138",1
2023-01-01,Região de Saúde Norte,"Hospital de Braga, EPE",75,0,75,2023,1,"-8.398982,41.56785",1
2023-01-01,Região de Saúde Norte,"Instituto Português Oncologia do Porto, EPE",20,24,44,2023,1,"-8.6062881,41.1785642",1
2023-01-01,Região de Saúde Norte,"Unidade Local de Saúde do Alto Minho, EPE",0,19,19,2023,1,"-8.8252713,41.7056054",1
2023-02-01,Região de Saúde do Alentejo,"Unidade Local de Saúde do Litoral Alentejano, EPE",3,5,8,2023,2,"-8.6956768,38.0162314",4
2023-02-01,Região de Saúde do Centro,"Centro Hospitalar Universitário Cova da Beira, EPE",766,2302,3068,2023,2,"-7.4922407,40.2804158",2
2023-02-01,Região de Saúde do Centro,Hospital Arcebispo João Crisóstomo,1,0,1,2023,2,"-8.5933462,40.3470015",2
2023-02-01,Região de Saúde do Centro,"Instituto Português Oncologia de Coimbra, EPE",0,5,5,2023,2,"-8.4103814,40.2162514",2
2023-02-01,Região de Saúde LVT,"Centro Hospitalar Barreiro/Montijo, EPE",518,528,1046,2023,2,"-9.0592392,38.6554005",3
2023-02-01,Região de Saúde LVT,"Centro Hospitalar Universitário Lisboa Central, EPE",132,809,941,2023,2,"-9.1371248,38.7166948",3
2023-02-01,Região de Saúde Norte,"Centro Hospitalar do Médio Ave, EPE",41,857,898,2023,2,"-8.4802503,41.3423984",1
2023-02-01,Região de Saúde Norte,"Centro Hospitalar Universitário de Santo António, EPE",391,411,802,2023,2,"-8.6172617,41.1472498",1
2023-02-01,Região de Saúde Norte,"Centro Hospitalar Vila Nova de Gaia/Espinho, EPE",63,0,63,2023,2,"-8.5972617,41.1094138",1
2023-02-01,Região de Saúde Norte,"Instituto Português Oncologia do Porto, EPE",37,41,78,2023,2,"-8.6062881,41.1785642",1
2023-03-01,Região de Saúde do Alentejo,"Hospital Espírito Santo de Évora, EPE",293,60,353,2023,3,"-7.9032848,38.5684861",4
2023-03-01,Região de Saúde do Alentejo,"Unidade Local de Saúde do Baixo Alentejo, EPE",109,166,275,2023,3,"-7.8721227,38.014123",4
2023-03-01,Região de Saúde do Alentejo,"Unidade Local de Saúde do Litoral Alentejano, EPE",3,5,8,2023,3,"-8.6956768,38.0162314",4
2023-03-01,Região de Saúde do Centro,"Centro Hospitalar Universitário Cova da Beira, EPE",1239,3752,4991,2023,3,"-7.4922407,40.2804158",2
2023-03-01,Região de Saúde do Centro,"Instituto Português Oncologia de Coimbra, EPE",0,7,7,2023,3,"-8.4103814,40.2162514",2
2023-03-01,Região de Saúde do Centro,"Unidade Local de Saúde de Castelo Branco, EPE",941,1428,2369,2023,3,"-7.4981271,39.8212263",2
2023-03-01,Região de Saúde LVT,"Centro Hospitalar de Lisboa Ocidental, EPE",67,592,659,2023,3,"-9.216985,38.708454",3
2023-03-01,Região de Saúde LVT,"Centro Hospitalar Médio Tejo, EPE",0,0,0,2023,3,"-8.5404429,39.478072",3
2023-03-01,Região de Saúde LVT,"Hospital Garcia de Orta, EPE",186,2753,2939,2023,3,"-9.1822554,38.6658713",3
2023-03-01,Região de Saúde Norte,"Centro Hospitalar Universitário de São João, EPE",0,0,0,2023,3,"-8.6010558,41.1831056",1
2023-03-01,Região de Saúde Norte,"Centro Hospitalar Póvoa de Varzim/Vila do Conde, EPE",115,3,118,2023,3,"-8.7589945,41.3828711",1
2023-03-01,Região de Saúde Norte,"Centro Hospitalar Universitário de Santo António, EPE",559,597,1156,2023,3,"-8.6172617,41.1472498",1
2023-04-01,Região de Saúde do Centro,"Centro Hospitalar de Leiria, EPE",108,115,223,2023,4,"-8.7982706,39.7414812",2
2023-04-01,Região de Saúde do Centro,Hospital Arcebispo João Crisóstomo,4,0,4,2023,4,"-8.5933462,40.3470015",2
2023-04-01,Região de Saúde do Centro,"Unidade Local de Saúde de Castelo Branco, EPE",1163,1857,3020,2023,4,"-7.4981271,39.8212263",2
2023-04-01,Região de Saúde LVT,"Centro Hospitalar Barreiro/Montijo, EPE",993,1157,2150,2023,4,"-9.0592392,38.6554005",3
2023-04-01,Região de Saúde LVT,"Centro Hospitalar de Lisboa Ocidental, EPE",91,784,875,2023,4,"-9.216985,38.708454",3
2023-04-01,Região de Saúde LVT,"Centro Hospitalar de Setúbal, EPE",66,108,174,2023,4,"-8.8818638,38.5283754",3
2023-04-01,Região de Saúde LVT,"Centro Hospitalar do Oeste, EPE, EPE",1274,3458,4732,2023,4,"-9.1258493,39.4054629",3
2023-04-01,Região de Saúde LVT,"Hospital de Vila Franca de Xira, EPE",60,0,60,2023,4,"-8.984506,38.977235",3
2023-04-01,Região de Saúde LVT,"Hospital Professor Doutor Fernando Fonseca, EPE",1102,9742,10844,2023,4,"-9.2264834,38.7422257",3
2023-04-01,Região de Saúde Norte,"Centro Hospitalar Vila Nova de Gaia/Espinho, EPE",124,0,124,2023,4,"-8.5972617,41.1094138",1
2023-04-01,Região de Saúde Norte,"Unidade Local de Saúde do Alto Minho, EPE",3,41,44,2023,4,"-8.8252713,41.7056054",1
2023-05-01,Região de Saúde do Algarve,"Centro Hospitalar Universitário do Algarve,EPE",0,0,0,2023,5,"-7.9281554,37.0238973",5
2023-05-01,Região de Saúde do Centro,"Centro Hospitalar e Universitário de Coimbra, EPE",3060,1445,4505,2023,5,"-8.4098211,40.2191523",2
2023-05-01,Região de Saúde LVT,"Centro Hospitalar do Oeste, EPE, EPE",1569,4273,5842,2023,5,"-9.1258493,39.4054629",3
2023-05-01,Região de Saúde LVT,"Centro Hospitalar Universitário de Lisboa Norte, EPE",3053,29,3082,2023,5,"-9.1616116,38.7500861",3
2023-05-01,Região de Saúde LVT,"Hospital de Vila Franca de Xira, EPE",90,0,90,2023,5,"-8.984506,38.977235",3
2023-05-01,Região de Saúde Norte,"Centro Hospitalar Vila Nova de Gaia/Espinho, EPE",156,0,156,2023,5,"-8.5972617,41.1094138",1
2023-05-01,Região de Saúde Norte,"Hospital de Braga, EPE",295,0,295,2023,5,"-8.398982,41.56785",1
2023-05-01,Região de Saúde Norte,"Unidade Local de Saúde de Matosinhos, EPE",0,3387,3387,2023,5,"-8.6745115,41.1794456",1
2023-05-01,Região de Saúde Norte,"Unidade Local de Saúde do Alto Minho, EPE",3,50,53,2023,5,"-8.8252713,41.7056054",1
2023-06-01,Região de Saúde do Alentejo,"Unidade Local de Saúde do Norte Alentejano, EPE",363,382,745,2023,6,"-7.4263845,39.3003425",4
2023-06-01,Região de Saúde do Centro,"Centro Hospitalar e Universitário de Coimbra, EPE",3597,1780,5377,2023,6,"-8.4098211,40.2191523",2
2023-06-01,Região de Saúde do Centro,Centro Medicina de Reabilitação da Região Centro Rovisco Pais,118,43,161,2023,6,"-8.7707806,40.297919",2
2023-06-01,Região de Saúde do Centro,"Hospital Distrital da Figueira da Foz, EPE",525,1326,1851,2023,6,"-8.8586755,40.117897",2
2023-06-01,Região de Saúde do Centro,"Instituto Português Oncologia de Coimbra, EPE",0,15,15,2023,6,"-8.4103814,40.2162514",2
2023-06-01,Região de Saúde LVT,"Centro Hospitalar Universitário Lisboa Central, EPE",781,3229,4010,2023,6,"-9.1371248,38.7166948",3
2023-06-01,Região de Saúde LVT,Centro Hospitalar Psiquiátrico de Lisboa,240,3475,3715,2023,6,"-9.1460705,38.7569771",3
2023-06-01,Região de Saúde Norte,"Centro Hospitalar do Médio Ave, EPE",138,2675,2813,2023,6,"-8.4802503,41.3423984",1
2023-07-01,Região de Saúde do Alentejo,"Unidade Local de Saúde do Litoral Alentejano, EPE",15,10,25,2023,7,"-8.6956768,38.0162314",4
2023-07-01,Região de Saúde do Alentejo,"Unidade Local de Saúde do Norte Alentejano, EPE",467,397,864,2023,7,"-7.4263845,39.3003425",4
2023-07-01,Região de Saúde do Centro,Centro Medicina de Reabilitação da Região Centro Rovisco Pais,127,53,180,2023,7,"-8.7707806,40.297919",2
2023-07-01,Região de Saúde LVT,"Centro Hospitalar de Lisboa Ocidental, EPE",162,1501,1663,2023,7,"-9.216985,38.708454",3
2023-07-01,Região de Saúde LVT,"Hospital de Vila Franca de Xira, EPE",134,0,134,2023,7,"-8.984506,38.977235",3
2023-07-01,Região de Saúde Norte,"Centro Hospitalar do Médio Ave, EPE",167,2980,3147,2023,7,"-8.4802503,41.3423984",1
2023-07-01,Região de Saúde Norte,"Centro Hospitalar Vila Nova de Gaia/Espinho, EPE",189,0,189,2023,7,"-8.5972617,41.1094138",1
2023-07-01,Região de Saúde Norte,"Hospital de Braga, EPE",353,0,353,2023,7,"-8.398982,41.56785",1
2023-07-01,Região de Saúde Norte,"Instituto Português Oncologia do Porto, EPE",98,116,214,2023,7,"-8.6062881,41.1785642",1
2023-08-01,Região de Saúde do Alentejo,"Unidade Local de Saúde do Norte Alentejano, EPE",538,451,989,2023,8,"-7.4263845,39.3003425",4
2023-08-01,Região de Saúde LVT,"Centro Hospitalar Universitário Lisboa Central, EPE",1207,6357,7564,2023,8,"-9.1371248,38.7166948",3
2023-08-01,Região de Saúde Norte,"Centro Hospitalar Póvoa de Varzim/Vila do Conde, EPE",343,62,405,2023,8,"-8.7589945,41.3828711",1
2023-08-01,Região de Saúde Norte,"Centro Hospitalar Vila Nova de Gaia/Espinho, EPE",232,0,232,2023,8,"-8.5972617,41.1094138",1
2023-08-01,Região de Saúde Norte,"Instituto Português Oncologia do Porto, EPE",112,128,240,2023,8,"-8.6062881,41.1785642",1
2023-09-01,Região de Saúde do Alentejo,"Hospital Espírito Santo de Évora, EPE",639,182,821,2023,9,"-7.9032848,38.5684861",4
2023-09-01,Região de Saúde do Alentejo,"Unidade Local de Saúde do Norte Alentejano, EPE",621,501,1122,2023,9,"-7.4263845,39.3003425",4
2023-09-01,Região de Saúde do Centro,"Centro Hospitalar e Universitário de Coimbra, EPE",5157,2562,7719,2023,9,"-8.4098211,40.2191523",2
2023-09-01,Região de Saúde do Centro,Hospital Arcebispo João Crisóstomo,20,0,20,2023,9,"-8.5933462,40.3470015",2
2023-09-01,Região de Saúde LVT,Centro Hospitalar Psiquiátrico de Lisboa,361,5063,5424,2023,9,"-9.1460705,38.7569771",3
2023-09-01,Região de Saúde LVT,"Hospital de Vila Franca de Xira, EPE",167,0,167,2023,9,"-8.984506,38.977235",3
2023-09-01,Região de Saúde Norte,"Hospital de Braga, EPE",416,0,416,2023,9,"-8.398982,41.56785",1
2023-09-01,Região de Saúde Norte,"Unidade Local de Saúde do Alto Minho, EPE",3,65,68,2023,9,"-8.8252713,41.7056054",1
2023-10-01,Região de Saúde do Centro,"Centro Hospitalar Universitário Cova da Beira, EPE",3813,11255,15068,2023,10,"-7.4922407,40.2804158",2
2023-10-01,Região de Saúde do Centro,Centro Medicina de Reabilitação da Região Centro Rovisco Pais,194,75,269,2023,10,"-8.7707806,40.297919",2
2023-10-01,Região de Saúde do Centro,"Instituto Português Oncologia de Coimbra, EPE",0,26,26,2023,10,"-8.4103814,40.2162514",2
2023-10-01,Região de Saúde Norte,"Centro Hospitalar do Médio Ave, EPE",228,4099,4327,2023,10,"-8.4802503,41.3423984",1
2023-11-01,Região de Saúde do Alentejo,"Unidade Local de Saúde do Litoral Alentejano, EPE",93,11,104,2023,11,"-8.6956768,38.0162314",4
2023-11-01,Região de Saúde do Alentejo,"Unidade Local de Saúde do Norte Alentejano, EPE",829,682,1511,2023,11,"-7.4263845,39.3003425",4
2023-11-01,Região de Saúde do Centro,Hospital Arcebispo João Crisóstomo,39,0,39,2023,11,"-8.5933462,40.3470015",2
2023-11-01,Região de Saúde LVT,"Centro Hospitalar Universitário Lisboa Central, EPE",1996,14637,16633,2023,11,"-9.1371248,38.7166948",3
2023-11-01,Região de Saúde Norte,"Centro Hospitalar Trás-os-Montes e Alto Douro, EPE",248,0,248,2023,11,"-7.7515252,41.3031784",1
2023-11-01,Região de Saúde Norte,"Centro Hospitalar Vila Nova de Gaia/Espinho, EPE",294,0,294,2023,11,"-8.5972617,41.1094138",1
2023-12-01,Região de Saúde do Alentejo,"Unidade Local de Saúde do Baixo Alentejo, EPE",334,655,989,2023,12,"-7.8721227,38.014123",4
2023-12-01,Região de Saúde do Alentejo,"Unidade Local de Saúde do Litoral Alentejano, EPE",109,11,120,2023,12,"-8.6956768,38.0162314",4
2023-12-01,Região de Saúde do Algarve,"Centro Hospitalar Universitário do Algarve,EPE",0,0,0,2023,12,"-7.9281554,37.0238973",5
2023-12-01,Região de Saúde do Centro,"Centro Hospitalar e Universitário de Coimbra, EPE",7027,3559,10586,2023,12,"-8.4098211,40.2191523",2
2023-12-01,Região de Saúde LVT,Centro Hospitalar Psiquiátrico de Lisboa,482,6545,7027,2023,12,"-9.1460705,38.7569771",3
2023-12-01,Região de Saúde Norte,"Centro Hospitalar Universitário de Santo António, EPE",2974,2340,5314,2023,12,"-8.6172617,41.1472498",1
2023-12-01,Região de Saúde Norte,"Unidade Local de Saúde do Alto Minho, EPE",3,77,80,2023,12,"-8.8252713,41.7056054",1
2013-01-01,Região de Saúde do Centro,"Centro Hospitalar e Universitário de Coimbra, EPE",11,22,33,2013,1,"-8.4098211,40.2191523",2
2013-02-01,Região de Saúde do Alentejo,"Unidade Local de Saúde do Norte Alentejano, EPE",174,193,367,2013,2,"-7.4263845,39.3003425",4
2013-02-01,Região de Saúde do Centro,"Centro Hospitalar e Universitário de Coimbra, EPE",104,66,170,2013,2,"-8.4098211,40.2191523",2
2013-03-01,Região de Saúde do Alentejo,"Hospital Espírito Santo de Évora, EPE",289,147,436,2013,3,"-7.9032848,38.5684861",4
2013-05-01,Região de Saúde do Alentejo,"Hospital Espírito Santo de Évora, EPE",466,242,708,2013,5,"-7.9032848,38.5684861",4
2013-05-01,Região de Saúde do Centro,"Centro Hospitalar do Baixo Vouga, EPE",200,214,414,2013,5,"-8.6543716,40.6362453",2
2013-05-01,Região de Saúde do Centro,"Centro Hospitalar e Universitário de Coimbra, EPE",681,523,1204,2013,5,"-8.4098211,40.2191523",2
2013-05-01,Região de Saúde LVT,"Hospital Professor Doutor Fernando Fonseca, EPE",0,0,0,2013,5,"-9.2264834,38.7422257",3
2013-06-01,Região de Saúde do Alentejo,"Unidade Local de Saúde do Baixo Alentejo, EPE",18,15,33,2013,6,"-7.8721227,38.014123",4
2013-06-01,Região de Saúde do Centro,"Centro Hospitalar Universitário Cova da Beira, EPE",139,57,196,2013,6,"-7.4922407,40.2804158",2
2013-06-01,Região de Saúde do Centro,"Centro Hospitalar Tondela-Viseu, EPE",170,124,294,2013,6,"-8.0827433,40.516364",2
2013-07-01,Região de Saúde do Centro,"Unidade Local de Saúde da Guarda, EPE",135,40,175,2013,7,"-7.2734793,40.5309916",2
2013-07-01,Região de Saúde do Centro,"Unidade Local de Saúde de Castelo Branco, EPE",81,56,137,2013,7,"-7.4981271,39.8212263",2
2013-07-01,Região de Saúde LVT,"Hospital Garcia de Orta, EPE",0,0,0,2013,7,"-9.1822554,38.6658713",3
2013-08-01,Região de Saúde do Alentejo,"Hospital Espírito Santo de Évora, EPE",751,385,1136,2013,8,"-7.9032848,38.5684861",4
2013-08-01,Região de Saúde do Centro,"Unidade Local de Saúde de Castelo Branco, EPE",81,56,137,2013,8,"-7.4981271,39.8212263",2
2013-08-01,Região de Saúde LVT,"Centro Hospitalar de Setúbal, EPE",0,0,0,2013,8,"-8.8818638,38.5283754",3
2013-08-01,Região de Saúde LVT,"Hospital Professor Doutor Fernando Fonseca, EPE",0,0,0,2013,8,"-9.2264834,38.7422257",3
2013-09-01,Região de Saúde do Centro,"Unidade Local de Saúde da Guarda, EPE",173,49,222,2013,9,"-7.2734793,40.5309916",2
2013-09-01,Região de Saúde LVT,"Centro Hospitalar de Setúbal, EPE",0,0,0,2013,9,"-8.8818638,38.5283754",3
2013-09-01,Região de Saúde Norte,"Unidade Local de Saúde de Matosinhos, EPE",862,0,862,2013,9,"-8.6745115,41.1794456",1
2013-10-01,Região de Saúde do Centro,"Unidade Local de Saúde da Guarda, EPE",192,52,244,2013,10,"-7.2734793,40.5309916",2
2013-10-01,Região de Saúde Norte,"Unidade Local de Saúde de Matosinhos, EPE",1016,0,1016,2013,10,"-8.6745115,41.1794456",1
2013-11-01,Região de Saúde do Centro,"Centro Hospitalar Tondela-Viseu, EPE",268,247,515,2013,11,"-8.0827433,40.516364",2
2013-11-01,Região de Saúde Norte,"Unidade Local de Saúde de Matosinhos, EPE",1225,0,1225,2013,11,"-8.6745115,41.1794456",1
2013-12-01,Região de Saúde do Algarve,"Centro Hospitalar Universitário do Algarve,EPE",657,113,770,2013,12,"-7.9281554,37.0238973",5
2013-12-01,Região de Saúde do Centro,"Centro Hospitalar Universitário Cova da Beira, EPE",220,197,417,2013,12,"-7.4922407,40.2804158",2
2013-12-01,Região de Saúde do Centro,"Unidade Local de Saúde da Guarda, EPE",234,64,298,2013,12,"-7.2734793,40.5309916",2
2013-12-01,Região de Saúde LVT,"Centro Hospitalar de Setúbal, EPE",0,0,0,2013,12,"-8.8818638,38.5283754",3
2013-12-01,Região de Saúde Norte,"Centro Hospitalar Trás-os-Montes e Alto Douro, EPE",572,0,572,2013,12,"-7.7515252,41.3031784",1
2014-01-01,Região de Saúde do Alentejo,"Hospital Espírito Santo de Évora, EPE",116,39,155,2014,1,"-7.9032848,38.5684861",4
2014-01-01,Região de Saúde do Alentejo,"Unidade Local de Saúde do Norte Alentejano, EPE",20,69,89,2014,1,"-7.4263845,39.3003425",4
2014-02-01,Região de Saúde do Alentejo,"Hospital Espírito Santo de Évora, EPE",225,95,320,2014,2,"-7.9032848,38.5684861",4
2014-02-01,Região de Saúde Norte,"Unidade Local de Saúde de Matosinhos, EPE",308,0,308,2014,2,"-8.6745115,41.1794456",1
2014-03-01,Região de Saúde do Centro,"Centro Hospitalar e Universitário de Coimbra, EPE",357,243,600,2014,3,"-8.4098211,40.2191523",2
2014-03-01,Região de Saúde LVT,"Centro Hospitalar do Oeste, EPE",0,4,4,2014,3,"-9.1258493,39.4054629",3
2014-03-01,Região de Saúde LVT,"Hospital Professor Doutor Fernando Fonseca, EPE",0,0,0,2014,3,"-9.2264834,38.7422257",3
2014-03-01,Região de Saúde Norte,"Unidade Local de Saúde de Matosinhos, EPE",470,0,470,2014,3,"-8.6745115,41.1794456",1
2014-04-01,Região de Saúde do Centro,"Unidade Local de Saúde de Castelo Branco, EPE",77,47,124,2014,4,"-7.4981271,39.8212263",2
2014-04-01,Região de Saúde LVT,"Centro Hospitalar de Setúbal, EPE",0,0,0,2014,4,"-8.8818638,38.5283754",3
2014-05-01,Região de Saúde do Alentejo,"Hospital Espírito Santo de Évora, EPE",564,263,827,2014,5,"-7.9032848,38.5684861",4
2014-05-01,Região de Saúde do Algarve,"Centro Hospitalar Universitário do Algarve,EPE",416,39,455,2014,5,"-7.9281554,37.0238973",5
2014-05-01,Região de Saúde do Centro,"Centro Hospitalar Tondela-Viseu, EPE",127,137,264,2014,5,"-8.0827433,40.516364",2
2014-05-01,Região de Saúde LVT,"Centro Hospitalar de Setúbal, EPE",0,0,0,2014,5,"-8.8818638,38.5283754",3
2014-06-01,Região de Saúde do Alentejo,"Hospital Espírito Santo de Évora, EPE",634,291,925,2014,6,"-7.9032848,38.5684861",4
2014-06-01,Região de Saúde do Alentejo,"Unidade Local de Saúde do Baixo Alentejo, EPE",36,17,53,2014,6,"-7.8721227,38.014123",4
2014-06-01,Região de Saúde do Alentejo,"Unidade Local de Saúde do Norte Alentejano, EPE",340,562,902,2014,6,"-7.4263845,39.3003425",4
2014-06-01,Região de Saúde do Centro,"Centro Hospitalar Universitário Cova da Beira, EPE",148,85,233,2014,6,"-7.4922407,40.2804158",2
2014-06-01,Região de Saúde do Centro,"Unidade Local de Saúde da Guarda, EPE",135,25,160,2014,6,"-7.2734793,40.5309916",2
2014-07-01,Região de Saúde do Centro,"Centro Hospitalar do Baixo Vouga, EPE",294,336,630,2014,7,"-8.6543716,40.6362453",2
2014-07-01,Região de Saúde do Centro,"Centro Hospitalar Tondela-Viseu, EPE",170,177,347,2014,7,"-8.0827433,40.516364",2
2014-07-01,Região de Saúde Norte,"Centro Hospitalar Universitário do Porto, EPE",214,0,214,2014,7,"-8.6172617,41.1472498",1
2014-07-01,Região de Saúde Norte,"Unidade Local de Saúde de Matosinhos, EPE",1255,0,1255,2014,7,"-8.6745115,41.1794456",1
2014-08-01,Região de Saúde do Alentejo,"Unidade Local de Saúde do Baixo Alentejo, EPE",46,26,72,2014,8,"-7.8721227,38.014123",4
2014-08-01,Região de Saúde LVT,"Centro Hospitalar do Oeste, EPE",2,9,11,2014,8,"-9.1258493,39.4054629",3
2014-08-01,Região de Saúde LVT,"Hospital Professor Doutor Fernando Fonseca, EPE",0,0,0,2014,8,"-9.2264834,38.7422257",3
2014-08-01,Região de Saúde Norte,"Centro Hospitalar Universitário do Porto, EPE",252,0,252,2014,8,"-8.6172617,41.1472498",1
2014-08-01,Região de Saúde Norte,"Centro Hospitalar Trás-os-Montes e Alto Douro, EPE",368,0,368,2014,8,"-7.7515252,41.3031784",1
2014-09-01,Região de Saúde do Centro,"Centro Hospitalar Tondela-Viseu, EPE",214,216,430,2014,9,"-8.0827433,40.516364",2
2014-09-01,Região de Saúde LVT,"Centro Hospitalar de Setúbal, EPE",0,0,0,2014,9,"-8.8818638,38.5283754",3
2014-09-01,Região de Saúde Norte,"Unidade Local de Saúde de Matosinhos, EPE",1541,0,1541,2014,9,"-8.6745115,41.1794456",1
2014-10-01,Região de Saúde do Alentejo,"Unidade Local de Saúde do Baixo Alentejo, EPE",49,40,89,2014,10,"-7.8721227,38.014123",4
2014-10-01,Região de Saúde LVT,"Centro Hospitalar de Setúbal, EPE",0,0,0,2014,10,"-8.8818638,38.5283754",3
2014-10-01,Região de Saúde Norte,"Unidade Local de Saúde de Matosinhos, EPE",1679,0,1679,2014,10,"-8.6745115,41.1794456",1
2014-11-01,Região de Saúde do Alentejo,"Unidade Local de Saúde do Baixo Alentejo, EPE",50,41,91,2014,11,"-7.8721227,38.014123",4
2014-11-01,Região de Saúde do Centro,"Unidade Local de Saúde de Castelo Branco, EPE",131,106,237,2014,11,"-7.4981271,39.8212263",2
2014-11-01,Região de Saúde LVT,"Centro Hospitalar de Setúbal, EPE",0,0,0,2014,11,"-8.8818638,38.5283754",3
2014-11-01,Região de Saúde LVT,"Hospital Garcia de Orta, EPE",0,0,0,2014,11,"-9.1822554,38.6658713",3
2014-11-01,Região de Saúde Norte,"Unidade Local de Saúde de Matosinhos, EPE",1811,0,1811,2014,11,"-8.6745115,41.1794456",1
2014-12-01,Região de Saúde do Centro,"Centro Hospitalar Universitário Cova da Beira, EPE",274,147,421,2014,12,"-7.4922407,40.2804158",2
2014-12-01,Região de Saúde do Centro,"Centro Hospitalar do Baixo Vouga, EPE",514,564,1078,2014,12,"-8.6543716,40.6362453",2
2014-12-01,Região de Saúde do Centro,"Centro Hospitalar Tondela-Viseu, EPE",291,284,575,2014,12,"-8.0827433,40.516364",2
2014-12-01,Região de Saúde do Centro,"Unidade Local de Saúde da Guarda, EPE",173,39,212,2014,12,"-7.2734793,40.5309916",2
2014-12-01,Região de Saúde LVT,"Centro Hospitalar do Oeste, EPE",3,16,19,2014,12,"-9.1258493,39.4054629",3
2014-12-01,Região de Saúde Norte,"Unidade Local de Saúde de Matosinhos, EPE",1894,0,1894,2014,12,"-8.6745115,41.1794456",1
2015-01-01,Região de Saúde do Alentejo,"Hospital Espírito Santo de Évora, EPE",102,47,149,2015,1,"-7.9032848,38.5684861",4
2015-01-01,Região de Saúde do Alentejo,"Unidade Local de Saúde do Norte Alentejano, EPE",96,67,163,2015,1,"-7.4263845,39.3003425",4
2015-01-01,Região de Saúde do Algarve,"Centro Hospitalar Universitário do Algarve,EPE",104,9,113,2015,1,"-7.9281554,37.0238973",5
2015-01-01,Região de Saúde Norte,"Unidade Local de Saúde de Matosinhos, EPE",121,0,121,2015,1,"-8.6745115,41.1794456",1
2015-03-01,Região de Saúde do Algarve,"Centro Hospitalar Universitário do Algarve,EPE",298,27,325,2015,3,"-7.9281554,37.0238973",5
2015-03-01,Região de Saúde do Centro,"Centro Hospitalar do Baixo Vouga, EPE",121,177,298,2015,3,"-8.6543716,40.6362453",2
2015-03-01,Região de Saúde LVT,"Centro Hospitalar de Setúbal, EPE",0,0,0,2015,3,"-8.8818638,38.5283754",3
2015-04-01,Região de Saúde do Centro,"Centro Hospitalar do Baixo Vouga, EPE",149,235,384,2015,4,"-8.6543716,40.6362453",2
2015-04-01,Região de Saúde do Centro,"Unidade Local de Saúde de Castelo Branco, EPE",52,35,87,2015,4,"-7.4981271,39.8212263",2
2015-05-01,Região de Saúde do Centro,"Centro Hospitalar Tondela-Viseu, EPE",131,122,253,2015,5,"-8.0827433,40.516364",2
2015-06-01,Região de Saúde do Centro,"Centro Hospitalar Tondela-Viseu, EPE",155,153,308,2015,6,"-8.0827433,40.516364",2
2015-07-01,Região de Saúde do Centro,"Centro Hospitalar do Baixo Vouga, EPE",313,365,678,2015,7,"-8.6543716,40.6362453",2
2015-07-01,Região de Saúde do Centro,"Unidade Local de Saúde de Castelo Branco, EPE",86,76,162,2015,7,"-7.4981271,39.8212263",2
2015-07-01,Região de Saúde Norte,"Centro Hospitalar Universitário do Porto, EPE",244,0,244,2015,7,"-8.6172617,41.1472498",1
2015-08-01,Região de Saúde do Algarve,"Centro Hospitalar Universitário do Algarve,EPE",807,76,883,2015,8,"-7.9281554,37.0238973",5
2015-08-01,Região de Saúde do Centro,"Centro Hospitalar Universitário Cova da Beira, EPE",184,82,266,2015,8,"-7.4922407,40.2804158",2
2015-08-01,Região de Saúde do Centro,"Centro Hospitalar Tondela-Viseu, EPE",216,201,417,2015,8,"-8.0827433,40.516364",2
2015-08-01,Região de Saúde do Centro,"Unidade Local de Saúde de Castelo Branco, EPE",86,76,162,2015,8,"-7.4981271,39.8212263",2
2015-09-01,Região de Saúde do Alentejo,"Unidade Local de Saúde do Norte Alentejano, EPE",643,631,1274,2015,9,"-7.4263845,39.3003425",4
2015-09-01,Região de Saúde do Centro,"Centro Hospitalar e Universitário de Coimbra, EPE",1558,1129,2687,2015,9,"-8.4098211,40.2191523",2
2015-09-01,Região de Saúde LVT,"Centro Hospitalar de Setúbal, EPE",0,0,0,2015,9,"-8.8818638,38.5283754",3
2015-10-01,Região de Saúde do Alentejo,"Unidade Local de Saúde do Norte Alentejano, EPE",687,715,1402,2015,10,"-7.4263845,39.3003425",4
2015-10-01,Região de Saúde do Algarve,"Centro Hospitalar Universitário do Algarve,EPE",1035,99,1134,2015,10,"-7.9281554,37.0238973",5
2015-11-01,Região de Saúde do Algarve,"Centro Hospitalar Universitário do Algarve,EPE",1206,113,1319,2015,11,"-7.9281554,37.0238973",5
2015-11-01,Região de Saúde do Centro,"Unidade Local de Saúde da Guarda, EPE",122,0,122,2015,11,"-7.2734793,40.5309916",2
2015-11-01,Região de Saúde do Centro,"Unidade Local de Saúde de Castelo Branco, EPE",128,129,257,2015,11,"-7.4981271,39.8212263",2
2015-12-01,Região de Saúde do Alentejo,"Hospital Espírito Santo de Évora, EPE",1118,530,1648,2015,12,"-7.9032848,38.5684861",4
2015-12-01,Região de Saúde do Centro,"Centro Hospitalar do Baixo Vouga, EPE",526,571,1097,2015,12,"-8.6543716,40.6362453",2
2015-12-01,Região de Saúde do Centro,"Unidade Local de Saúde da Guarda, EPE",172,0,172,2015,12,"-7.2734793,40.5309916",2
2015-12-01,Região de Saúde LVT,"Centro Hospitalar de Setúbal, EPE",0,0,0,2015,12,"-8.8818638,38.5283754",3
2016-01-01,Região de Saúde do Alentejo,"Unidade Local de Saúde do Norte Alentejano, EPE",56,49,105,2016,1,"-7.4263845,39.3003425",4
2016-01-01,Região de Saúde do Centro,"Unidade Local de Saúde da Guarda, EPE",35,0,35,2016,1,"-7.2734793,40.5309916",2
2016-01-01,Região de Saúde Norte,"Centro Hospitalar Universitário de São João, EPE",0,0,0,2016,1,"-8.6010558,41.1831056",1
2016-01-01,Região de Saúde Norte,"Unidade Local de Saúde de Matosinhos, EPE",164,0,164,2016,1,"-8.6745115,41.1794456",1
2016-02-01,Região de Saúde do Centro,"Centro Hospitalar do Baixo Vouga, EPE",94,112,206,2016,2,"-8.6543716,40.6362453",2
2016-02-01,Região de Saúde do Centro,"Unidade Local de Saúde de Castelo Branco, EPE",50,22,72,2016,2,"-7.4981271,39.8212263",2
2016-02-01,Região de Saúde LVT,"Centro Hospitalar de Setúbal, EPE",0,0,0,2016,2,"-8.8818638,38.5283754",3
2016-03-01,Região de Saúde do Alentejo,"Unidade Local de Saúde do Norte Alentejano, EPE",168,179,347,2016,3,"-7.4263845,39.3003425",4
2016-03-01,Região de Saúde do Centro,"Centro Hospitalar e Universitário de Coimbra, EPE",701,381,1082,2016,3,"-8.4098211,40.2191523",2
2016-03-01,Região de Saúde do Centro,"Centro Hospitalar Tondela-Viseu, EPE",74,61,135,2016,3,"-8.0827433,40.516364",2
2016-03-01,Região de Saúde Norte,"Unidade Local de Saúde de Matosinhos, EPE",512,0,512,2016,3,"-8.6745115,41.1794456",1
2016-04-01,Região de Saúde do Alentejo,"Unidade Local de Saúde do Baixo Alentejo, EPE",14,9,23,2016,4,"-7.8721227,38.014123",4
2016-04-01,Região de Saúde do Centro,"Centro Hospitalar Universitário Cova da Beira, EPE",78,44,122,2016,4,"-7.4922407,40.2804158",2
2016-04-01,Região de Saúde do Centro,"Centro Hospitalar e Universitário de Coimbra, EPE",925,503,1428,2016,4,"-8.4098211,40.2191523",2
2016-05-01,Região de Saúde do Centro,"Centro Hospitalar do Baixo Vouga, EPE",245,241,486,2016,5,"-8.6543716,40.6362453",2
2016-05-01,Região de Saúde do Centro,"Unidade Local de Saúde de Castelo Branco, EPE",99,52,151,2016,5,"-7.4981271,39.8212263",2
2016-06-01,Região de Saúde do Alentejo,"Unidade Local de Saúde do Baixo Alentejo, EPE",14,9,23,2016,6,"-7.8721227,38.014123",4
2016-06-01,Região de Saúde do Centro,Centro Medicina de Reabilitação da Região Centro Rovisco Pais,7,0,7,2016,6,"-8.7707806,40.297919",2
2016-06-01,Região de Saúde do Centro,"Unidade Local de Saúde da Guarda, EPE",230,0,230,2016,6,"-7.2734793,40.5309916",2
2016-06-01,Região de Saúde Norte,"Centro Hospitalar Universitário de São João, EPE",0,0,0,2016,6,"-8.6010558,41.1831056",1
2016-07-01,Região de Saúde do Algarve,"Centro Hospitalar Universitário do Algarve,EPE",1062,94,1156,2016,7,"-7.9281554,37.0238973",5
2016-07-01,Região de Saúde do Centro,"Centro Hospitalar Universitário Cova da Beira, EPE",115,101,216,2016,7,"-7.4922407,40.2804158",2
2016-07-01,Região de Saúde LVT,"Instituto Português Oncologia de Lisboa, EPE",1,0,1,2016,7,"-9.1634516,38.7396768",3
2016-07-01,Região de Saúde Norte,"Centro Hospitalar Trás-os-Montes e Alto Douro, EPE",346,0,346,2016,7,"-7.7515252,41.3031784",1
2016-08-01,Região de Saúde do Algarve,"Centro Hospitalar Universitário do Algarve,EPE",1197,94,1291,2016,8,"-7.9281554,37.0238973",5
2016-08-01,Região de Saúde do Centro,Centro Medicina de Reabilitação da Região Centro Rovisco Pais,16,1,17,2016,8,"-8.7707806,40.297919",2
2016-08-01,Região de Saúde Norte,"Unidade Local de Saúde de Matosinhos, EPE",1243,0,1243,2016,8,"-8.6745115,41.1794456",1
2016-09-01,Região de Saúde do Centro,"Centro Hospitalar Universitário Cova da Beira, EPE",129,117,246,2016,9,"-7.4922407,40.2804158",2
2016-09-01,Região de Saúde LVT,"Hospital Garcia de Orta, EPE",55,0,55,2016,9,"-9.1822554,38.6658713",3
2016-09-01,Região de Saúde LVT,"Instituto Português Oncologia de Lisboa, EPE",1,0,1,2016,9,"-9.1634516,38.7396768",3
2016-09-01,Região de Saúde Norte,"Centro Hospitalar Universitário de São João, EPE",0,0,0,2016,9,"-8.6010558,41.1831056",1
2016-10-01,Região de Saúde do Centro,Centro Medicina de Reabilitação da Região Centro Rovisco Pais,22,1,23,2016,10,"-8.7707806,40.297919",2
2016-10-01,Região de Saúde do Centro,"Unidade Local de Saúde da Guarda, EPE",334,0,334,2016,10,"-7.2734793,40.5309916",2
2016-10-01,Região de Saúde LVT,"Hospital Garcia de Orta, EPE",69,0,69,2016,10,"-9.1822554,38.6658713",3
2016-10-01,Região de Saúde Norte,"Centro Hospitalar Trás-os-Montes e Alto Douro, EPE",497,11,508,2016,10,"-7.7515252,41.3031784",1
2016-11-01,Região de Saúde do Alentejo,"Hospital Espírito Santo de Évora, EPE",968,326,1294,2016,11,"-7.9032848,38.5684861",4
2016-11-01,Região de Saúde do Alentejo,"Unidade Local de Saúde do Baixo Alentejo, EPE",21,17,38,2016,11,"-7.8721227,38.014123",4
2016-11-01,Região de Saúde do Centro,"Centro Hospitalar Universitário Cova da Beira, EPE",166,137,303,2016,11,"-7.4922407,40.2804158",2
2016-11-01,Região de Saúde do Centro,"Unidade Local de Saúde de Castelo Branco, EPE",137,108,245,2016,11,"-7.4981271,39.8212263",2
2016-11-01,Região de Saúde LVT,"Hospital Garcia de Orta, EPE",99,0,99,2016,11,"-9.1822554,38.6658713",3
2016-11-01,Região de Saúde Norte,"Centro Hospitalar Universitário de São João, EPE",0,0,0,2016,11,"-8.6010558,41.1831056",1
2016-12-01,Região de Saúde do Alentejo,"Hospital Espírito Santo de Évora, EPE",1002,348,1350,2016,12,"-7.9032848,38.5684861",4
2016-12-01,Região de Saúde do Centro,"Unidade Local de Saúde de Castelo Branco, EPE",150,116,266,2016,12,"-7.4981271,39.8212263",2
2016-12-01,Região de Saúde Norte,"Centro Hospitalar Universitário de São João, EPE",0,0,0,2016,12,"-8.6010558,41.1831056",1
2017-01-01,Região de Saúde do Centro,"Centro Hospitalar Tondela-Viseu, EPE",22,9,31,2017,1,"-8.0827433,40.516364",2
2017-01-01,Região de Saúde do Centro,"Unidade Local de Saúde de Castelo Branco, EPE",12,0,12,2017,1,"-7.4981271,39.8212263",2
2017-01-01,Região de Saúde Norte,"Centro Hospitalar Trás-os-Montes e Alto Douro, EPE",51,0,51,2017,1,"-7.7515252,41.3031784",1
2017-01-01,Região de Saúde Norte,"Unidade Local de Saúde de Matosinhos, EPE",237,1191,1428,2017,1,"-8.6745115,41.1794456",1
2017-02-01,Região de Saúde do Alentejo,"Unidade Local de Saúde do Baixo Alentejo, EPE",0,0,0,2017,2,"-7.8721227,38.014123",4
2017-02-01,Região de Saúde do Algarve,"Centro Hospitalar Universitário do Algarve,EPE",96,2,98,2017,2,"-7.9281554,37.0238973",5
2017-02-01,Região de Saúde Norte,"Centro Hospitalar Trás-os-Montes e Alto Douro, EPE",92,0,92,2017,2,"-7.7515252,41.3031784",1
2017-03-01,Região de Saúde do Centro,"Centro Hospitalar e Universitário de Coimbra, EPE",648,342,990,2017,3,"-8.4098211,40.2191523",2
2017-04-01,Região de Saúde do Alentejo,"Unidade Local de Saúde do Litoral Alentejano, EPE",5,3,8,2017,4,"-8.6956768,38.0162314",4
2017-04-01,Região de Saúde do Centro,"Centro Hospitalar do Baixo Vouga, EPE",168,191,359,2017,4,"-8.6543716,40.6362453",2
2017-04-01,Região de Saúde do Centro,"Centro Hospitalar e Universitário de Coimbra, EPE",807,410,1217,2017,4,"-8.4098211,40.2191523",2
2017-04-01,Região de Saúde do Centro,"Centro Hospitalar Tondela-Viseu, EPE",56,37,93,2017,4,"-8.0827433,40.516364",2
2017-04-01,Região de Saúde LVT,"Centro Hospitalar Universitário Lisboa Central, EPE",3,3,6,2017,4,"-9.1371248,38.7166948",3
2017-05-01,Região de Saúde do Alentejo,"Unidade Local de Saúde do Norte Alentejano, EPE",297,252,549,2017,5,"-7.4263845,39.3003425",4
2017-05-01,Região de Saúde do Centro,"Centro Hospitalar Tondela-Viseu, EPE",74,52,126,2017,5,"-8.0827433,40.516364",2
2017-06-01,Região de Saúde do Alentejo,"Hospital Espírito Santo de Évora, EPE",444,161,605,2017,6,"-7.9032848,38.5684861",4
2017-06-01,Região de Saúde do Algarve,"Centro Hospitalar Universitário do Algarve,EPE",240,5,245,2017,6,"-7.9281554,37.0238973",5
2017-06-01,Região de Saúde do Centro,"Centro Hospitalar de Leiria, EPE",205,136,341,2017,6,"-8.7982706,39.7414812",2
2017-06-01,Região de Saúde do Centro,"Centro Hospitalar e Universitário de Coimbra, EPE",1234,600,1834,2017,6,"-8.4098211,40.2191523",2
2017-06-01,Região de Saúde LVT,"Centro Hospitalar Universitário Lisboa Central, EPE",10,8,18,2017,6,"-9.1371248,38.7166948",3
2017-06-01,Região de Saúde Norte,"Unidade Local de Saúde de Matosinhos, EPE",1204,6752,7956,2017,6,"-8.6745115,41.1794456",1
2017-07-01,Região de Saúde do Algarve,"Centro Hospitalar Universitário do Algarve,EPE",366,5,371,2017,7,"-7.9281554,37.0238973",5
2017-07-01,Região de Saúde do Centro,"Centro Hospitalar Universitário Cova da Beira, EPE",114,62,176,2017,7,"-7.4922407,40.2804158",2
2017-07-01,Região de Saúde do Centro,"Centro Hospitalar Tondela-Viseu, EPE",105,72,177,2017,7,"-8.0827433,40.516364",2
2017-07-01,Região de Saúde do Centro,Centro Medicina de Reabilitação da Região Centro Rovisco Pais,25,1,26,2017,7,"-8.7707806,40.297919",2
2017-07-01,Região de Saúde Norte,"Centro Hospitalar Trás-os-Montes e Alto Douro, EPE",288,1,289,2017,7,"-7.7515252,41.3031784",1
2017-08-01,Região de Saúde do Alentejo,"Hospital Espírito Santo de Évora, EPE",572,208,780,2017,8,"-7.9032848,38.5684861",4
2017-08-01,Região de Saúde do Alentejo,"Unidade Local de Saúde do Norte Alentejano, EPE",465,406,871,2017,8,"-7.4263845,39.3003425",4
2017-08-01,Região de Saúde do Centro,"Centro Hospitalar do Baixo Vouga, EPE",354,337,691,2017,8,"-8.6543716,40.6362453",2
2017-08-01,Região de Saúde do Centro,Centro Medicina de Reabilitação da Região Centro Rovisco Pais,26,1,27,2017,8,"-8.7707806,40.297919",2
2017-08-01,Região de Saúde do Centro,"Unidade Local de Saúde de Castelo Branco, EPE",221,69,290,2017,8,"-7.4981271,39.8212263",2
2017-08-01,Região de Saúde Norte,"Centro Hospitalar Universitário do Porto, EPE",1067,0,1067,2017,8,"-8.6172617,41.1472498",1
2017-08-01,Região de Saúde Norte,"Unidade Local de Saúde de Matosinhos, EPE",1784,8978,10762,2017,8,"-8.6745115,41.1794456",1
2017-09-01,Região de Saúde do Alentejo,"Hospital Espírito Santo de Évora, EPE",624,231,855,2017,9,"-7.9032848,38.5684861",4
2017-09-01,Região de Saúde do Centro,"Centro Hospitalar de Leiria, EPE",307,188,495,2017,9,"-8.7982706,39.7414812",2
2017-09-01,Região de Saúde do Centro,"Unidade Local de Saúde de Castelo Branco, EPE",233,92,325,2017,9,"-7.4981271,39.8212263",2
2017-09-01,Região de Saúde LVT,"Centro Hospitalar Universitário Lisboa Central, EPE",19,22,41,2017,9,"-9.1371248,38.7166948",3
2017-09-01,Região de Saúde Norte,"Unidade Local de Saúde do Nordeste, EPE",3,0,3,2017,9,"-6.7888197,41.8056532",1
2017-10-01,Região de Saúde do Alentejo,"Unidade Local de Saúde do Litoral Alentejano, EPE",19,20,39,2017,10,"-8.6956768,38.0162314",4
2017-10-01,Região de Saúde do Centro,"Centro Hospitalar Tondela-Viseu, EPE",170,111,281,2017,10,"-8.0827433,40.516364",2
2017-11-01,Região de Saúde do Centro,"Centro Hospitalar do Baixo Vouga, EPE",515,492,1007,2017,11,"-8.6543716,40.6362453",2
2017-11-01,Região de Saúde LVT,"Hospital Garcia de Orta, EPE",250,0,250,2017,11,"-9.1822554,38.6658713",3
2017-11-01,Região de Saúde Norte,"Unidade Local de Saúde do Nordeste, EPE",3,0,3,2017,11,"-6.7888197,41.8056532",1
2017-12-01,Região de Saúde do Centro,"Centro Hospitalar e Universitário de Coimbra, EPE",2441,1128,3569,2017,12,"-8.4098211,40.2191523",2
2017-12-01,Região de Saúde do Centro,"Centro Hospitalar Tondela-Viseu, EPE",198,130,328,2017,12,"-8.0827433,40.516364",2
2017-12-01,Região de Saúde do Centro,"Unidade Local de Saúde da Guarda, EPE",479,0,479,2017,12,"-7.2734793,40.5309916",2
2018-01-01,Região de Saúde do Centro,"Centro Hospitalar de Leiria, EPE",38,29,67,2018,1,"-8.7982706,39.7414812",2
2018-01-01,Região de Saúde do Centro,"Centro Hospitalar e Universitário de Coimbra, EPE",116,45,161,2018,1,"-8.4098211,40.2191523",2
2018-02-01,Região de Saúde do Alentejo,"Hospital Espírito Santo de Évora, EPE",141,81,222,2018,2,"-7.9032848,38.5684861",4
2018-02-01,Região de Saúde do Centro,"Centro Hospitalar de Leiria, EPE",81,45,126,2018,2,"-8.7982706,39.7414812",2
2018-02-01,Região de Saúde do Centro,"Centro Hospitalar e Universitário de Coimbra, EPE",331,100,431,2018,2,"-8.4098211,40.2191523",2
2018-02-01,Região de Saúde LVT,"Centro Hospitalar Universitário Lisboa Central, EPE",1,6,7,2018,2,"-9.1371248,38.7166948",3
2018-02-01,Região de Saúde LVT,"Centro Hospitalar Médio Tejo, EPE",0,0,0,2018,2,"-8.5404429,39.478072",3
2018-03-01,Região de Saúde do Alentejo,"Unidade Local de Saúde do Baixo Alentejo, EPE",4,2,6,2018,3,"-7.8721227,38.014123",4
2018-03-01,Região de Saúde do Alentejo,"Unidade Local de Saúde do Norte Alentejano, EPE",128,190,318,2018,3,"-7.4263845,39.3003425",4
2018-03-01,Região de Saúde do Centro,Centro Medicina de Reabilitação da Região Centro Rovisco Pais,8,1,9,2018,3,"-8.7707806,40.297919",2
2018-03-01,Região de Saúde Norte,"Centro Hospitalar Universitário do Porto, EPE",505,0,505,2018,3,"-8.6172617,41.1472498",1
2018-03-01,Região de Saúde Norte,"Centro Hospitalar Trás-os-Montes e Alto Douro, EPE",89,0,89,2018,3,"-7.7515252,41.3031784",1
2018-04-01,Região de Saúde do Centro,Centro Medicina de Reabilitação da Região Centro Rovisco Pais,10,1,11,2018,4,"-8.7707806,40.297919",2
2018-04-01,Região de Saúde do Centro,"Unidade Local de Saúde da Guarda, EPE",224,0,224,2018,4,"-7.2734793,40.5309916",2
2018-04-01,Região de Saúde Norte,"Centro Hospitalar Trás-os-Montes e Alto Douro, EPE",101,0,101,2018,4,"-7.7515252,41.3031784",1
2018-05-01,Região de Saúde do Algarve,"Centro Hospitalar Universitário do Algarve,EPE",8,3,11,2018,5,"-7.9281554,37.0238973",5
2018-05-01,Região de Saúde do Centro,"Centro Hospitalar Tondela-Viseu, EPE",42,22,64,2018,5,"-8.0827433,40.516364",2
2018-05-01,Região de Saúde do Centro,"Unidade Local de Saúde de Castelo Branco, EPE",130,67,197,2018,5,"-7.4981271,39.8212263",2
2018-05-01,Região de Saúde Norte,"Unidade Local de Saúde do Nordeste, EPE",0,1,1,2018,5,"-6.7888197,41.8056532",1
2018-06-01,Região de Saúde do Alentejo,"Unidade Local de Saúde do Litoral Alentejano, EPE",12,19,31,2018,6,"-8.6956768,38.0162314",4
2018-06-01,Região de Saúde do Centro,"Centro Hospitalar de Leiria, EPE",192,128,320,2018,6,"-8.7982706,39.7414812",2
2018-06-01,Região de Saúde do Centro,"Unidade Local de Saúde de Castelo Branco, EPE",144,82,226,2018,6,"-7.4981271,39.8212263",2
2018-06-01,Região de Saúde LVT,"Centro Hospitalar Universitário Lisboa Central, EPE",15,21,36,2018,6,"-9.1371248,38.7166948",3
2018-06-01,Região de Saúde LVT,"Hospital Garcia de Orta, EPE",291,0,291,2018,6,"-9.1822554,38.6658713",3
2018-06-01,Região de Saúde Norte,"Unidade Local de Saúde do Nordeste, EPE",0,1,1,2018,6,"-6.7888197,41.8056532",1
2018-07-01,Região de Saúde do Alentejo,"Unidade Local de Saúde do Norte Alentejano, EPE",378,330,708,2018,7,"-7.4263845,39.3003425",4
2018-07-01,Região de Saúde do Centro,"Centro Hospitalar Universitário Cova da Beira, EPE",275,100,375,2018,7,"-7.4922407,40.2804158",2
2018-07-01,Região de Saúde do Centro,"Centro Hospitalar de Leiria, EPE",206,154,360,2018,7,"-8.7982706,39.7414812",2
2018-07-01,Região de Saúde do Centro,"Centro Hospitalar Tondela-Viseu, EPE",94,78,172,2018,7,"-8.0827433,40.516364",2
2018-07-01,Região de Saúde Norte,"Instituto Português Oncologia do Porto, EPE",66,51,117,2018,7,"-8.6062881,41.1785642",1
2018-07-01,Região de Saúde Norte,"Unidade Local de Saúde do Nordeste, EPE",0,1,1,2018,7,"-6.7888197,41.8056532",1
2018-08-01,Região de Saúde do Alentejo,"Unidade Local de Saúde do Baixo Alentejo, EPE",32,13,45,2018,8,"-7.8721227,38.014123",4
2018-08-01,Região de Saúde do Centro,"Centro Hospitalar de Leiria, EPE",240,165,405,2018,8,"-8.7982706,39.7414812",2
2018-08-01,Região de Saúde do Centro,Centro Medicina de Reabilitação da Região Centro Rovisco Pais,26,2,28,2018,8,"-8.7707806,40.297919",2
2018-08-01,Região de Saúde do Centro,Hospital Arcebispo João Crisóstomo,11,0,11,2018,8,"-8.5933462,40.3470015",2
2018-08-01,Região de Saúde LVT,"Hospital Garcia de Orta, EPE",376,0,376,2018,8,"-9.1822554,38.6658713",3
2018-08-01,Região de Saúde Norte,"Centro Hospitalar Trás-os-Montes e Alto Douro, EPE",189,0,189,2018,8,"-7.7515252,41.3031784",1
2018-09-01,Região de Saúde do Alentejo,"Hospital Espírito Santo de Évora, EPE",645,249,894,2018,9,"-7.9032848,38.5684861",4
2018-09-01,Região de Saúde do Alentejo,"Unidade Local de Saúde do Baixo Alentejo, EPE",34,16,50,2018,9,"-7.8721227,38.014123",4
2018-09-01,Região de Saúde do Centro,Centro Medicina de Reabilitação da Região Centro Rovisco Pais,33,2,35,2018,9,"-8.7707806,40.297919",2
2018-09-01,Região de Saúde do Centro,"Unidade Local de Saúde da Guarda, EPE",489,0,489,2018,9,"-7.2734793,40.5309916",2
2018-09-01,Região de Saúde LVT,"Hospital Garcia de Orta, EPE",429,0,429,2018,9,"-9.1822554,38.6658713",3
2018-09-01,Região de Saúde Norte,"Hospital Santa Maria Maior, EPE",1,0,1,2018,9,"-8.6171561,41.5324234",1
2018-09-01,Região de Saúde Norte,"Instituto Português Oncologia do Porto, EPE",87,58,145,2018,9,"-8.6062881,41.1785642",1
2018-09-01,Região de Saúde Norte,"Unidade Local de Saúde de Matosinhos, EPE",0,9500,9500,2018,9,"-8.6745115,41.1794456",1
2018-10-01,Região de Saúde do Centro,"Centro Hospitalar Tondela-Viseu, EPE",153,117,270,2018,10,"-8.0827433,40.516364",2
2018-10-01,Região de Saúde LVT,"Centro Hospitalar Universitário Lisboa Central, EPE",41,38,79,2018,10,"-9.1371248,38.7166948",3
2018-10-01,Região de Saúde Norte,"Centro Hospitalar Universitário do Porto, EPE",2089,0,2089,2018,10,"-8.6172617,41.1472498",1
2018-11-01,Região de Saúde do Alentejo,"Unidade Local de Saúde do Litoral Alentejano, EPE",26,34,60,2018,11,"-8.6956768,38.0162314",4
2018-11-01,Região de Saúde do Centro,Hospital Arcebispo João Crisóstomo,30,0,30,2018,11,"-8.5933462,40.3470015",2
2018-11-01,Região de Saúde LVT,"Centro Hospitalar Universitário Lisboa Central, EPE",43,38,81,2018,11,"-9.1371248,38.7166948",3
2018-11-01,Região de Saúde LVT,"Hospital Garcia de Orta, EPE",538,0,538,2018,11,"-9.1822554,38.6658713",3
2018-11-01,Região de Saúde Norte,"Instituto Português Oncologia do Porto, EPE",103,67,170,2018,11,"-8.6062881,41.1785642",1
2018-12-01,Região de Saúde do Alentejo,"Unidade Local de Saúde do Baixo Alentejo, EPE",48,24,72,2018,12,"-7.8721227,38.014123",4
2018-12-01,Região de Saúde do Centro,"Centro Hospitalar de Leiria, EPE",330,277,607,2018,12,"-8.7982706,39.7414812",2
2018-12-01,Região de Saúde do Centro,"Centro Hospitalar e Universitário de Coimbra, EPE",2015,906,2921,2018,12,"-8.4098211,40.2191523",2
2018-12-01,Região de Saúde LVT,"Centro Hospitalar Universitário de Lisboa Norte, EPE",793,3,796,2018,12,"-9.1616116,38.7500861",3
2018-12-01,Região de Saúde Norte,"Centro Hospitalar Entre Douro e Vouga, EPE",4,0,4,2018,12,"-8.5458794,40.9293884",1
2018-12-01,Região de Saúde Norte,"Unidade Local de Saúde do Nordeste, EPE",0,1,1,2018,12,"-6.7888197,41.8056532",1
2019-01-01,Região de Saúde do Alentejo,"Hospital Espírito Santo de Évora, EPE",113,40,153,2019,1,"-7.9032848,38.5684861",4
2019-01-01,Região de Saúde do Alentejo,"Unidade Local de Saúde do Litoral Alentejano, EPE",4,3,7,2019,1,"-8.6956768,38.0162314",4
2019-01-01,Região de Saúde do Centro,"Centro Hospitalar de Leiria, EPE",31,21,52,2019,1,"-8.7982706,39.7414812",2
2019-01-01,Região de Saúde LVT,"Centro Hospitalar de Setúbal, EPE",0,0,0,2019,1,"-8.8818638,38.5283754",3
2019-01-01,Região de Saúde Norte,"Instituto Português Oncologia do Porto, EPE",5,2,7,2019,1,"-8.6062881,41.1785642",1
2019-01-01,Região de Saúde Norte,"Unidade Local de Saúde de Matosinhos, EPE",0,1088,1088,2019,1,"-8.6745115,41.1794456",1
2019-02-01,Região de Saúde do Alentejo,"Unidade Local de Saúde do Norte Alentejano, EPE",127,52,179,2019,2,"-7.4263845,39.3003425",4
2019-02-01,Região de Saúde do Centro,"Centro Hospitalar Universitário Cova da Beira, EPE",122,14,136,2019,2,"-7.4922407,40.2804158",2
2019-02-01,Região de Saúde do Centro,"Centro Hospitalar de Leiria, EPE",58,39,97,2019,2,"-8.7982706,39.7414812",2
2019-02-01,Região de Saúde do Centro,"Centro Hospitalar e Universitário de Coimbra, EPE",371,107,478,2019,2,"-8.4098211,40.2191523",2
2019-02-01,Região de Saúde do Centro,Hospital Arcebispo João Crisóstomo,7,0,7,2019,2,"-8.5933462,40.3470015",2
2019-02-01,Região de Saúde LVT,"Hospital Garcia de Orta, EPE",0,0,0,2019,2,"-9.1822554,38.6658713",3
2019-03-01,Região de Saúde do Alentejo,"Unidade Local de Saúde do Norte Alentejano, EPE",169,66,235,2019,3,"-7.4263845,39.3003425",4
2019-03-01,Região de Saúde do Centro,"Centro Hospitalar do Baixo Vouga, EPE",150,127,277,2019,3,"-8.6543716,40.6362453",2
2019-03-01,Região de Saúde do Centro,"Centro Hospitalar Tondela-Viseu, EPE",39,20,59,2019,3,"-8.0827433,40.516364",2
2019-03-01,Região de Saúde do Centro,Hospital Arcebispo João Crisóstomo,21,0,21,2019,3,"-8.5933462,40.3470015",2
2019-03-01,Região de Saúde Norte,"Centro Hospitalar Universitário do Porto, EPE",666,0,666,2019,3,"-8.6172617,41.1472498",1
2019-04-01,Região de Saúde do Alentejo,"Hospital Espírito Santo de Évora, EPE",501,244,745,2019,4,"-7.9032848,38.5684861",4
2019-04-01,Região de Saúde do Algarve,"Centro Hospitalar Universitário do Algarve,EPE",0,0,0,2019,4,"-7.9281554,37.0238973",5
2019-04-01,Região de Saúde do Centro,"Centro Hospitalar do Baixo Vouga, EPE",221,155,376,2019,4,"-8.6543716,40.6362453",2
2019-04-01,Região de Saúde do Centro,"Centro Hospitalar Tondela-Viseu, EPE",73,32,105,2019,4,"-8.0827433,40.516364",2
2019-04-01,Região de Saúde LVT,"Centro Hospitalar Médio Tejo, EPE",3,1,4,2019,4,"-8.5404429,39.478072",3
2019-04-01,Região de Saúde LVT,"Hospital Garcia de Orta, EPE",0,0,0,2019,4,"-9.1822554,38.6658713",3
2019-04-01,Região de Saúde Norte,"Unidade Local de Saúde de Matosinhos, EPE",0,3902,3902,2019,4,"-8.6745115,41.1794456",1
2019-05-01,Região de Saúde do Centro,"Centro Hospitalar Universitário Cova da Beira, EPE",235,40,275,2019,5,"-7.4922407,40.2804158",2
2019-05-01,Região de Saúde do Centro,"Centro Hospitalar do Baixo Vouga, EPE",295,209,504,2019,5,"-8.6543716,40.6362453",2
2019-05-01,Região de Saúde do Centro,"Centro Hospitalar e Universitário de Coimbra, EPE",1292,431,1723,2019,5,"-8.4098211,40.2191523",2
2019-05-01,Região de Saúde LVT,"Hospital Garcia de Orta, EPE",0,0,0,2019,5,"-9.1822554,38.6658713",3
2019-06-01,Região de Saúde do Alentejo,"Hospital Espírito Santo de Évora, EPE",744,349,1093,2019,6,"-7.9032848,38.5684861",4
2019-06-01,Região de Saúde do Centro,"Centro Hospitalar Tondela-Viseu, EPE",105,50,155,2019,6,"-8.0827433,40.516364",2
2019-06-01,Região de Saúde do Centro,"Unidade Local de Saúde de Castelo Branco, EPE",168,84,252,2019,6,"-7.4981271,39.8212263",2
2019-06-01,Região de Saúde LVT,"Centro Hospitalar Universitário Lisboa Central, EPE",22,21,43,2019,6,"-9.1371248,38.7166948",3
2019-06-01,Região de Saúde LVT,"Centro Hospitalar Universitário de Lisboa Norte, EPE",1418,9,1427,2019,6,"-9.1616116,38.7500861",3
2019-06-01,Região de Saúde Norte,"Hospital Santa Maria Maior, EPE",0,4,4,2019,6,"-8.6171561,41.5324234",1
2019-06-01,Região de Saúde Norte,"Instituto Português Oncologia do Porto, EPE",32,24,56,2019,6,"-8.6062881,41.1785642",1
2019-06-01,Região de Saúde Norte,"Unidade Local de Saúde de Matosinhos, EPE",0,5892,5892,2019,6,"-8.6745115,41.1794456",1
2019-07-01,Região de Saúde do Alentejo,"Unidade Local de Saúde do Baixo Alentejo, EPE",28,33,61,2019,7,"-7.8721227,38.014123",4
2019-07-01,Região de Saúde do Alentejo,"Unidade Local de Saúde do Litoral Alentejano, EPE",13,18,31,2019,7,"-8.6956768,38.0162314",4
2019-07-01,Região de Saúde do Centro,Hospital Arcebispo João Crisóstomo,66,0,66,2019,7,"-8.5933462,40.3470015",2
2019-07-01,Região de Saúde LVT,"Hospital Garcia de Orta, EPE",0,0,0,2019,7,"-9.1822554,38.6658713",3
2019-08-01,Região de Saúde do Alentejo,"Unidade Local de Saúde do Norte Alentejano, EPE",373,145,518,2019,8,"-7.4263845,39.3003425",4
2019-08-01,Região de Saúde do Algarve,"Centro Hospitalar Universitário do Algarve,EPE",0,0,0,2019,8,"-7.9281554,37.0238973",5
2019-08-01,Região de Saúde do Centro,"Centro Hospitalar Tondela-Viseu, EPE",160,63,223,2019,8,"-8.0827433,40.516364",2
2019-08-01,Região de Saúde LVT,"Hospital Garcia de Orta, EPE",0,0,0,2019,8,"-9.1822554,38.6658713",3
2019-08-01,Região de Saúde Norte,"Centro Hospitalar Universitário do Porto, EPE",1570,0,1570,2019,8,"-8.6172617,41.1472498",1
2019-09-01,Região de Saúde do Alentejo,"Unidade Local de Saúde do Norte Alentejano, EPE",406,154,560,2019,9,"-7.4263845,39.3003425",4
2019-09-01,Região de Saúde do Centro,"Centro Hospitalar de Leiria, EPE",243,208,451,2019,9,"-8.7982706,39.7414812",2
2019-09-01,Região de Saúde LVT,"Centro Hospitalar de Lisboa Ocidental, EPE",186,0,186,2019,9,"-9.216985,38.708454",3
2019-09-01,Região de Saúde LVT,"Centro Hospitalar de Setúbal, EPE",0,0,0,2019,9,"-8.8818638,38.5283754",3
2019-10-01,Região de Saúde do Algarve,"Centro Hospitalar Universitário do Algarve,EPE",0,0,0,2019,10,"-7.9281554,37.0238973",5
2019-10-01,Região de Saúde do Centro,"Centro Hospitalar e Universitário de Coimbra, EPE",2167,669,2836,2019,10,"-8.4098211,40.2191523",2
2019-10-01,Região de Saúde do Centro,Centro Medicina de Reabilitação da Região Centro Rovisco Pais,5,0,5,2019,10,"-8.7707806,40.297919",2
2019-10-01,Região de Saúde LVT,"Centro Hospitalar de Lisboa Ocidental, EPE",234,0,234,2019,10,"-9.216985,38.708454",3
2019-10-01,Região de Saúde LVT,"Centro Hospitalar Médio Tejo, EPE",13,9,22,2019,10,"-8.5404429,39.478072",3
2019-10-01,Região de Saúde Norte,"Unidade Local de Saúde de Matosinhos, EPE",0,9761,9761,2019,10,"-8.6745115,41.1794456",1
2019-11-01,Região de Saúde do Algarve,"Centro Hospitalar Universitário do Algarve,EPE",0,0,0,2019,11,"-7.9281554,37.0238973",5
2019-11-01,Região de Saúde do Centro,"Centro Hospitalar de Leiria, EPE",281,255,536,2019,11,"-8.7982706,39.7414812",2
2019-11-01,Região de Saúde do Centro,Centro Medicina de Reabilitação da Região Centro Rovisco Pais,5,0,5,2019,11,"-8.7707806,40.297919",2
2019-11-01,Região de Saúde do Centro,Hospital Arcebispo João Crisóstomo,104,0,104,2019,11,"-8.5933462,40.3470015",2
2019-11-01,Região de Saúde LVT,"Hospital Garcia de Orta, EPE",0,0,0,2019,11,"-9.1822554,38.6658713",3
2019-11-01,Região de Saúde Norte,"Centro Hospitalar Universitário do Porto, EPE",2145,0,2145,2019,11,"-8.6172617,41.1472498",1
2019-11-01,Região de Saúde Norte,"Instituto Português Oncologia do Porto, EPE",68,52,120,2019,11,"-8.6062881,41.1785642",1
2019-11-01,Região de Saúde Norte,"Unidade Local de Saúde de Matosinhos, EPE",0,10522,10522,2019,11,"-8.6745115,41.1794456",1
2019-12-01,Região de Saúde do Centro,"Centro Hospitalar Universitário Cova da Beira, EPE",442,80,522,2019,12,"-7.4922407,40.2804158",2
2019-12-01,Região de Saúde do Centro,"Centro Hospitalar do Baixo Vouga, EPE",686,464,1150,2019,12,"-8.6543716,40.6362453",2
2019-12-01,Região de Saúde do Centro,"Centro Hospitalar Tondela-Viseu, EPE",253,71,324,2019,12,"-8.0827433,40.516364",2
2019-12-01,Região de Saúde do Centro,Hospital Arcebispo João Crisóstomo,130,0,130,2019,12,"-8.5933462,40.3470015",2
2019-12-01,Região de Saúde LVT,"Centro Hospitalar Universitário Lisboa Central, EPE",26,26,52,2019,12,"-9.1371248,38.7166948",3
2019-12-01,Região de Saúde LVT,"Hospital Garcia de Orta, EPE",0,0,0,2019,12,"-9.1822554,38.6658713",3
2019-12-01,Região de Saúde Norte,"Centro Hospitalar Universitário do Porto, EPE",2312,0,2312,2019,12,"-8.6172617,41.1472498",1
2019-12-01,Região de Saúde Norte,"Hospital de Braga, EPE",1379,0,1379,2019,12,"-8.398982,41.56785",1
2019-12-01,Região de Saúde Norte,"Hospital Santa Maria Maior, EPE",0,4,4,2019,12,"-8.6171561,41.5324234",1
2020-01-01,Região de Saúde do Alentejo,"Hospital Espírito Santo de Évora, EPE",158,71,229,2020,1,"-7.9032848,38.5684861",4
2020-01-01,Região de Saúde do Alentejo,"Unidade Local de Saúde do Baixo Alentejo, EPE",0,0,0,2020,1,"-7.8721227,38.014123",4
2020-01-01,Região de Saúde do Centro,"Centro Hospitalar Tondela-Viseu, EPE",33,2,35,2020,1,"-8.0827433,40.516364",2
2020-01-01,Região de Saúde Norte,"Instituto Português Oncologia do Porto, EPE",8,6,14,2020,1,"-8.6062881,41.1785642",1
2020-02-01,Região de Saúde do Alentejo,"Hospital Espírito Santo de Évora, EPE",260,97,357,2020,2,"-7.9032848,38.5684861",4
2020-02-01,Região de Saúde do Alentejo,"Unidade Local de Saúde do Baixo Alentejo, EPE",0,0,0,2020,2,"-7.8721227,38.014123",4
2020-02-01,Região de Saúde do Algarve,"Centro Hospitalar Universitário do Algarve,EPE",0,0,0,2020,2,"-7.9281554,37.0238973",5
2020-02-01,Região de Saúde do Centro,"Centro Hospitalar Universitário Cova da Beira, EPE",51,9,60,2020,2,"-7.4922407,40.2804158",2
2020-02-01,Região de Saúde do Centro,"Centro Hospitalar de Leiria, EPE",29,32,61,2020,2,"-8.7982706,39.7414812",2
2020-02-01,Região de Saúde LVT,"Centro Hospitalar Universitário Lisboa Central, EPE",2,0,2,2020,2,"-9.1371248,38.7166948",3
2020-02-01,Região de Saúde LVT,"Centro Hospitalar Médio Tejo, EPE",1,8,9,2020,2,"-8.5404429,39.478072",3
2020-03-01,Região de Saúde do Centro,"Centro Hospitalar Universitário Cova da Beira, EPE",75,16,91,2020,3,"-7.4922407,40.2804158",2
2020-03-01,Região de Saúde do Centro,"Centro Hospitalar de Leiria, EPE",55,65,120,2020,3,"-8.7982706,39.7414812",2
2020-03-01,Região de Saúde LVT,"Centro Hospitalar Médio Tejo, EPE",2,8,10,2020,3,"-8.5404429,39.478072",3
2020-03-01,Região de Saúde Norte,"Centro Hospitalar Universitário do Porto, EPE",557,0,557,2020,3,"-8.6172617,41.1472498",1
2020-03-01,Região de Saúde Norte,"Centro Hospitalar Trás-os-Montes e Alto Douro, EPE",224,2,226,2020,3,"-7.7515252,41.3031784",1
2020-03-01,Região de Saúde Norte,"Instituto Português Oncologia do Porto, EPE",33,18,51,2020,3,"-8.6062881,41.1785642",1
2020-04-01,Região de Saúde do Alentejo,"Unidade Local de Saúde do Norte Alentejano, EPE",122,56,178,2020,4,"-7.4263845,39.3003425",4
2020-04-01,Região de Saúde do Centro,"Centro Hospitalar e Universitário de Coimbra, EPE",643,204,847,2020,4,"-8.4098211,40.2191523",2
2020-04-01,Região de Saúde Norte,"Centro Hospitalar Universitário de São João, EPE",0,0,0,2020,4,"-8.6010558,41.1831056",1
2020-04-01,Região de Saúde Norte,"Centro Hospitalar Póvoa de Varzim/Vila do Conde, EPE",0,8,8,2020,4,"-8.7589945,41.3828711",1
2020-05-01,Região de Saúde do Alentejo,"Unidade Local de Saúde do Baixo Alentejo, EPE",441,2339,2780,2020,5,"-7.8721227,38.014123",4
2020-05-01,Região de Saúde do Alentejo,"Unidade Local de Saúde do Norte Alentejano, EPE",132,86,218,2020,5,"-7.4263845,39.3003425",4
2020-05-01,Região de Saúde do Centro,"Centro Hospitalar Tondela-Viseu, EPE",75,10,85,2020,5,"-8.0827433,40.516364",2
2020-05-01,Região de Saúde do Centro,Hospital Arcebispo João Crisóstomo,84,0,84,2020,5,"-8.5933462,40.3470015",2
2020-05-01,Região de Saúde LVT,"Centro Hospitalar do Oeste, EPE, EPE",2,1,3,2020,5,"-9.1258493,39.4054629",3
2020-05-01,Região de Saúde LVT,"Centro Hospitalar Médio Tejo, EPE",2,10,12,2020,5,"-8.5404429,39.478072",3
2020-05-01,Região de Saúde LVT,"Hospital Garcia de Orta, EPE",0,0,0,2020,5,"-9.1822554,38.6658713",3
2020-05-01,Região de Saúde Norte,"Centro Hospitalar Entre Douro e Vouga, EPE",3,0,3,2020,5,"-8.5458794,40.9293884",1
2020-06-01,Região de Saúde do Alentejo,"Unidade Local de Saúde do Norte Alentejano, EPE",144,101,245,2020,6,"-7.4263845,39.3003425",4
2020-06-01,Região de Saúde do Centro,"Centro Hospitalar Universitário Cova da Beira, EPE",121,36,157,2020,6,"-7.4922407,40.2804158",2
2020-06-01,Região de Saúde do Centro,Hospital Arcebispo João Crisóstomo,84,0,84,2020,6,"-8.5933462,40.3470015",2
2020-06-01,Região de Saúde LVT,"Centro Hospitalar de Setúbal, EPE",0,0,0,2020,6,"-8.8818638,38.5283754",3
2020-06-01,Região de Saúde LVT,"Centro Hospitalar do Oeste, EPE, EPE",23,2,25,2020,6,"-9.1258493,39.4054629",3
2020-06-01,Região de Saúde Norte,"Centro Hospitalar Universitário do Porto, EPE",889,0,889,2020,6,"-8.6172617,41.1472498",1
2020-06-01,Região de Saúde Norte,"Centro Hospitalar Trás-os-Montes e Alto Douro, EPE",430,2,432,2020,6,"-7.7515252,41.3031784",1
2020-06-01,Região de Saúde Norte,"Hospital de Braga, EPE",2907,0,2907,2020,6,"-8.398982,41.56785",1
2020-07-01,Região de Saúde do Alentejo,"Hospital Espírito Santo de Évora, EPE",912,207,1119,2020,7,"-7.9032848,38.5684861",4
2020-07-01,Região de Saúde do Centro,"Centro Hospitalar Universitário Cova da Beira, EPE",151,40,191,2020,7,"-7.4922407,40.2804158",2
2020-07-01,Região de Saúde do Centro,"Centro Hospitalar do Baixo Vouga, EPE",169,199,368,2020,7,"-8.6543716,40.6362453",2
2020-07-01,Região de Saúde LVT,"Centro Hospitalar Universitário Lisboa Central, EPE",106,706,812,2020,7,"-9.1371248,38.7166948",3
2020-07-01,Região de Saúde LVT,"Centro Hospitalar Universitário de Lisboa Norte, EPE",1310,54,1364,2020,7,"-9.1616116,38.7500861",3
2020-07-01,Região de Saúde LVT,"Centro Hospitalar Médio Tejo, EPE",2,14,16,2020,7,"-8.5404429,39.478072",3
2020-07-01,Região de Saúde Norte,"Hospital de Braga, EPE",3192,0,3192,2020,7,"-8.398982,41.56785",1
2020-08-01,Região de Saúde do Centro,Hospital Arcebispo João Crisóstomo,92,0,92,2020,8,"-8.5933462,40.3470015",2
2020-08-01,Região de Saúde LVT,Centro Hospitalar Psiquiátrico de Lisboa,130,6207,6337,2020,8,"-9.1460705,38.7569771",3
2020-08-01,Região de Saúde Norte,"Centro Hospitalar Póvoa de Varzim/Vila do Conde, EPE",131,130,261,2020,8,"-8.7589945,41.3828711",1
2020-09-01,Região de Saúde LVT,"Centro Hospitalar do Oeste, EPE, EPE",43,7,50,2020,9,"-9.1258493,39.4054629",3
2020-09-01,Região de Saúde LVT,Centro Hospitalar Psiquiátrico de Lisboa,156,6978,7134,2020,9,"-9.1460705,38.7569771",3
2020-09-01,Região de Saúde Norte,"Centro Hospitalar Universitário do Porto, EPE",1367,0,1367,2020,9,"-8.6172617,41.1472498",1
2020-09-01,Região de Saúde Norte,"Instituto Português Oncologia do Porto, EPE",76,51,127,2020,9,"-8.6062881,41.1785642",1
2020-10-01,Região de Saúde do Alentejo,"Hospital Espírito Santo de Évora, EPE",1263,235,1498,2020,10,"-7.9032848,38.5684861",4
2020-10-01,Região de Saúde do Centro,"Centro Hospitalar Universitário Cova da Beira, EPE",222,61,283,2020,10,"-7.4922407,40.2804158",2
2020-10-01,Região de Saúde do Centro,"Centro Hospitalar Tondela-Viseu, EPE",195,37,232,2020,10,"-8.0827433,40.516364",2
2020-10-01,Região de Saúde LVT,"Centro Hospitalar Universitário Lisboa Central, EPE",1,23,24,2020,10,"-9.1371248,38.7166948",3
2020-10-01,Região de Saúde LVT,"Centro Hospitalar de Setúbal, EPE",0,0,0,2020,10,"-8.8818638,38.5283754",3
2020-10-01,Região de Saúde LVT,"Centro Hospitalar do Oeste, EPE, EPE",45,7,52,2020,10,"-9.1258493,39.4054629",3
2020-10-01,Região de Saúde Norte,"Centro Hospitalar Universitário do Porto, EPE",1525,0,1525,2020,10,"-8.6172617,41.1472498",1
2020-10-01,Região de Saúde Norte,"Hospital de Braga, EPE",4352,0,4352,2020,10,"-8.398982,41.56785",1
2020-10-01,Região de Saúde Norte,"Unidade Local de Saúde de Matosinhos, EPE",0,7563,7563,2020,10,"-8.6745115,41.1794456",1
2020-11-01,Região de Saúde do Algarve,"Centro Hospitalar Universitário do Algarve,EPE",0,0,0,2020,11,"-7.9281554,37.0238973",5
2020-11-01,Região de Saúde do Centro,"Centro Hospitalar do Baixo Vouga, EPE",331,392,723,2020,11,"-8.6543716,40.6362453",2
2020-11-01,Região de Saúde do Centro,"Unidade Local de Saúde de Castelo Branco, EPE",129,95,224,2020,11,"-7.4981271,39.8212263",2
2020-11-01,Região de Saúde LVT,"Centro Hospitalar de Lisboa Ocidental, EPE",177,0,177,2020,11,"-9.216985,38.708454",3
2020-11-01,Região de Saúde LVT,"Centro Hospitalar do Oeste, EPE, EPE",53,8,61,2020,11,"-9.1258493,39.4054629",3
2020-11-01,Região de Saúde LVT,"Centro Hospitalar Universitário de Lisboa Norte, EPE",2129,59,2188,2020,11,"-9.1616116,38.7500861",3
2020-11-01,Região de Saúde Norte,"Centro Hospitalar Póvoa de Varzim/Vila do Conde, EPE",281,233,514,2020,11,"-8.7589945,41.3828711",1
2020-11-01,Região de Saúde Norte,"Centro Hospitalar Vila Nova de Gaia/Espinho, EPE",978,0,978,2020,11,"-8.5972617,41.1094138",1
2020-11-01,Região de Saúde Norte,"Instituto Português Oncologia do Porto, EPE",86,63,149,2020,11,"-8.6062881,41.1785642",1
2020-12-01,Região de Saúde do Alentejo,"Hospital Espírito Santo de Évora, EPE",1467,260,1727,2020,12,"-7.9032848,38.5684861",4
2020-12-01,Região de Saúde LVT,"Hospital Distrital de Santarém, EPE",0,37,37,2020,12,"-8.6937515,39.2410946",3
2020-12-01,Região de Saúde Norte,"Centro Hospitalar Universitário do Porto, EPE",1727,0,1727,2020,12,"-8.6172617,41.1472498",1
2020-12-01,Região de Saúde Norte,"Centro Hospitalar Entre Douro e Vouga, EPE",240,104,344,2020,12,"-8.5458794,40.9293884",1
2020-12-01,Região de Saúde Norte,"Hospital de Braga, EPE",4469,0,4469,2020,12,"-8.398982,41.56785",1
2021-01-01,Região de Saúde do Centro,"Centro Hospitalar de Leiria, EPE",27,22,49,2021,1,"-8.7982706,39.7414812",2
2021-01-01,Região de Saúde do Centro,"Hospital Distrital da Figueira da Foz, EPE",482,1253,1735,2021,1,"-8.8586755,40.117897",2
2021-01-01,Região de Saúde do Centro,"Unidade Local de Saúde de Castelo Branco, EPE",44,11,55,2021,1,"-7.4981271,39.8212263",2
2021-01-01,Região de Saúde LVT,"Centro Hospitalar Universitário Lisboa Central, EPE",467,311,778,2021,1,"-9.1371248,38.7166948",3
2021-01-01,Região de Saúde LVT,"Hospital Garcia de Orta, EPE",0,1,1,2021,1,"-9.1822554,38.6658713",3
2021-02-01,Região de Saúde do Alentejo,"Unidade Local de Saúde do Baixo Alentejo, EPE",314,495,809,2021,2,"-7.8721227,38.014123",4
2021-02-01,Região de Saúde do Centro,"Centro Hospitalar de Leiria, EPE",59,40,99,2021,2,"-8.7982706,39.7414812",2
2021-02-01,Região de Saúde LVT,"Centro Hospitalar Universitário Lisboa Central, EPE",916,594,1510,2021,2,"-9.1371248,38.7166948",3
2021-02-01,Região de Saúde LVT,"Hospital Distrital de Santarém, EPE",0,14,14,2021,2,"-8.6937515,39.2410946",3
2021-02-01,Região de Saúde Norte,"Centro Hospitalar Trás-os-Montes e Alto Douro, EPE",64,0,64,2021,2,"-7.7515252,41.3031784",1
2021-02-01,Região de Saúde Norte,"Hospital da Senhora da Oliveira, Guimarães, EPE",183,0,183,2021,2,"-8.3086907,41.4387173",1
2021-03-01,Região de Saúde do Alentejo,"Unidade Local de Saúde do Baixo Alentejo, EPE",470,683,1153,2021,3,"-7.8721227,38.014123",4
2021-03-01,Região de Saúde do Centro,"Centro Hospitalar de Leiria, EPE",90,67,157,2021,3,"-8.7982706,39.7414812",2
2021-03-01,Região de Saúde do Centro,Hospital Arcebispo João Crisóstomo,31,0,31,2021,3,"-8.5933462,40.3470015",2
2021-03-01,Região de Saúde LVT,"Centro Hospitalar Barreiro/Montijo, EPE",0,11,11,2021,3,"-9.0592392,38.6554005",3
2021-03-01,Região de Saúde LVT,"Centro Hospitalar Universitário Lisboa Central, EPE",1374,790,2164,2021,3,"-9.1371248,38.7166948",3
2021-03-01,Região de Saúde LVT,"Centro Hospitalar de Lisboa Ocidental, EPE",29,0,29,2021,3,"-9.216985,38.708454",3
2021-03-01,Região de Saúde LVT,Centro Hospitalar Psiquiátrico de Lisboa,139,2545,2684,2021,3,"-9.1460705,38.7569771",3
2021-03-01,Região de Saúde Norte,"Centro Hospitalar Universitário do Porto, EPE",428,0,428,2021,3,"-8.6172617,41.1472498",1
2021-03-01,Região de Saúde Norte,"Centro Hospitalar Trás-os-Montes e Alto Douro, EPE",116,0,116,2021,3,"-7.7515252,41.3031784",1
2021-03-01,Região de Saúde Norte,"Centro Hospitalar Vila Nova de Gaia/Espinho, EPE",289,0,289,2021,3,"-8.5972617,41.1094138",1
2021-03-01,Região de Saúde Norte,"Hospital de Magalhães Lemos, EPE",0,2200,2200,2021,3,"-8.6649823,41.1764649",1
2021-03-01,Região de Saúde Norte,"Unidade Local de Saúde de Matosinhos, EPE",0,2501,2501,2021,3,"-8.6745115,41.1794456",1
2021-04-01,Região de Saúde do Alentejo,"Unidade Local de Saúde do Litoral Alentejano, EPE",4,0,4,2021,4,"-8.6956768,38.0162314",4
2021-04-01,Região de Saúde do Centro,"Centro Hospitalar do Baixo Vouga, EPE",155,147,302,2021,4,"-8.6543716,40.6362453",2
2021-04-01,Região de Saúde LVT,"Centro Hospitalar de Setúbal, EPE",274,203,477,2021,4,"-8.8818638,38.5283754",3
2021-04-01,Região de Saúde Norte,"Centro Hospitalar do Médio Ave, EPE",22,300,322,2021,4,"-8.4802503,41.3423984",1
2021-04-01,Região de Saúde Norte,"Centro Hospitalar Trás-os-Montes e Alto Douro, EPE",194,0,194,2021,4,"-7.7515252,41.3031784",1
2021-05-01,Região de Saúde do Algarve,"Centro Hospitalar Universitário do Algarve,EPE",0,0,0,2021,5,"-7.9281554,37.0238973",5
2021-05-01,Região de Saúde do Centro,"Centro Hospitalar Universitário Cova da Beira, EPE",4688,12582,17270,2021,5,"-7.4922407,40.2804158",2
2021-05-01,Região de Saúde do Centro,"Centro Hospitalar de Leiria, EPE",148,104,252,2021,5,"-8.7982706,39.7414812",2
2021-05-01,Região de Saúde do Centro,"Unidade Local de Saúde de Castelo Branco, EPE",118,90,208,2021,5,"-7.4981271,39.8212263",2
2021-05-01,Região de Saúde LVT,Centro Hospitalar Psiquiátrico de Lisboa,256,4150,4406,2021,5,"-9.1460705,38.7569771",3
2021-05-01,Região de Saúde Norte,"Centro Hospitalar Universitário do Porto, EPE",818,0,818,2021,5,"-8.6172617,41.1472498",1
2021-05-01,Região de Saúde Norte,"Hospital da Senhora da Oliveira, Guimarães, EPE",600,0,600,2021,5,"-8.3086907,41.4387173",1
2021-05-01,Região de Saúde Norte,"Hospital de Braga, EPE",183,0,183,2021,5,"-8.398982,41.56785",1
2021-05-01,Região de Saúde Norte,"Unidade Local de Saúde de Matosinhos, EPE",0,3998,3998,2021,5,"-8.6745115,41.1794456",1
2021-06-01,Região de Saúde do Alentejo,"Unidade Local de Saúde do Litoral Alentejano, EPE",11,0,11,2021,6,"-8.6956768,38.0162314",4
2021-06-01,Região de Saúde do Centro,"Hospital Distrital da Figueira da Foz, EPE",2374,5348,7722,2021,6,"-8.8586755,40.117897",2
2021-06-01,Região de Saúde LVT,"Centro Hospitalar Barreiro/Montijo, EPE",3,58,61,2021,6,"-9.0592392,38.6554005",3
2021-06-01,Região de Saúde LVT,"Centro Hospitalar Universitário Lisboa Central, EPE",3301,1530,4831,2021,6,"-9.1371248,38.7166948",3
2021-06-01,Região de Saúde LVT,"Hospital Distrital de Santarém, EPE",0,33,33,2021,6,"-8.6937515,39.2410946",3
2021-06-01,Região de Saúde LVT,"Hospital Professor Doutor Fernando Fonseca, EPE",2,30,32,2021,6,"-9.2264834,38.7422257",3
2021-06-01,Região de Saúde Norte,"Centro Hospitalar Universitário de São João, EPE",0,0,0,2021,6,"-8.6010558,41.1831056",1
2021-06-01,Região de Saúde Norte,"Centro Hospitalar do Médio Ave, EPE",58,554,612,2021,6,"-8.4802503,41.3423984",1
2021-06-01,Região de Saúde Norte,"Centro Hospitalar Trás-os-Montes e Alto Douro, EPE",334,0,334,2021,6,"-7.7515252,41.3031784",1
2021-06-01,Região de Saúde Norte,"Hospital da Senhora da Oliveira, Guimarães, EPE",642,0,642,2021,6,"-8.3086907,41.4387173",1
2021-07-01,Região de Saúde do Centro,"Centro Hospitalar do Baixo Vouga, EPE",236,210,446,2021,7,"-8.6543716,40.6362453",2
2021-07-01,Região de Saúde do Centro,Hospital Arcebispo João Crisóstomo,67,0,67,2021,7,"-8.5933462,40.3470015",2
2021-07-01,Região de Saúde do Centro,"Hospital Distrital da Figueira da Foz, EPE",2587,5722,8309,2021,7,"-8.8586755,40.117897",2
2021-07-01,Região de Saúde LVT,"Centro Hospitalar Barreiro/Montijo, EPE",5,69,74,2021,7,"-9.0592392,38.6554005",3
2021-07-01,Região de Saúde LVT,"Centro Hospitalar do Oeste, EPE, EPE",4337,20396,24733,2021,7,"-9.1258493,39.4054629",3
2021-07-01,Região de Saúde LVT,"Centro Hospitalar Médio Tejo, EPE",0,0,0,2021,7,"-8.5404429,39.478072",3
2021-07-01,Região de Saúde LVT,"Hospital Distrital de Santarém, EPE",1,33,34,2021,7,"-8.6937515,39.2410946",3
2021-07-01,Região de Saúde LVT,"Hospital Professor Doutor Fernando Fonseca, EPE",2,52,54,2021,7,"-9.2264834,38.7422257",3
2021-07-01,Região de Saúde Norte,"Centro Hospitalar Entre Douro e Vouga, EPE",58,13,71,2021,7,"-8.5458794,40.9293884",1
2021-07-01,Região de Saúde Norte,"Centro Hospitalar Póvoa de Varzim/Vila do Conde, EPE",400,203,603,2021,7,"-8.7589945,41.3828711",1
2021-07-01,Região de Saúde Norte,"Centro Hospitalar Trás-os-Montes e Alto Douro, EPE",392,0,392,2021,7,"-7.7515252,41.3031784",1
2021-07-01,Região de Saúde Norte,"Instituto Português Oncologia do Porto, EPE",60,50,110,2021,7,"-8.6062881,41.1785642",1
2021-08-01,Região de Saúde do Centro,"Centro Hospitalar Universitário Cova da Beira, EPE",6971,17519,24490,2021,8,"-7.4922407,40.2804158",2
2021-08-01,Região de Saúde do Centro,"Centro Hospitalar do Baixo Vouga, EPE",250,226,476,2021,8,"-8.6543716,40.6362453",2
2021-08-01,Região de Saúde do Centro,"Centro Hospitalar e Universitário de Coimbra, EPE",22180,91491,113671,2021,8,"-8.4098211,40.2191523",2
2021-08-01,Região de Saúde LVT,"Centro Hospitalar do Oeste, EPE, EPE",4679,21953,26632,2021,8,"-9.1258493,39.4054629",3
2021-08-01,Região de Saúde LVT,"Centro Hospitalar Médio Tejo, EPE",0,0,0,2021,8,"-8.5404429,39.478072",3
2021-08-01,Região de Saúde LVT,"Hospital Distrital de Santarém, EPE",2,33,35,2021,8,"-8.6937515,39.2410946",3
2021-08-01,Região de Saúde Norte,"Centro Hospitalar Universitário de São João, EPE",0,0,0,2021,8,"-8.6010558,41.1831056",1
2021-08-01,Região de Saúde Norte,"Hospital de Braga, EPE",353,0,353,2021,8,"-8.398982,41.56785",1
2021-08-01,Região de Saúde Norte,"Hospital de Magalhães Lemos, EPE",0,2200,2200,2021,8,"-8.6649823,41.1764649",1
2021-08-01,Região de Saúde Norte,"Instituto Português Oncologia do Porto, EPE",66,57,123,2021,8,"-8.6062881,41.1785642",1
2021-09-01,Região de Saúde do Centro,Hospital Arcebispo João Crisóstomo,80,0,80,2021,9,"-8.5933462,40.3470015",2
2021-09-01,Região de Saúde LVT,"Centro Hospitalar Universitário Lisboa Central, EPE",4851,1977,6828,2021,9,"-9.1371248,38.7166948",3
2021-09-01,Região de Saúde LVT,"Centro Hospitalar do Oeste, EPE, EPE",5044,23910,28954,2021,9,"-9.1258493,39.4054629",3
2021-09-01,Região de Saúde LVT,"Centro Hospitalar Universitário de Lisboa Norte, EPE",3168,706,3874,2021,9,"-9.1616116,38.7500861",3
2021-09-01,Região de Saúde LVT,"Hospital Distrital de Santarém, EPE",2,34,36,2021,9,"-8.6937515,39.2410946",3
2021-09-01,Região de Saúde Norte,"Centro Hospitalar Universitário de São João, EPE",0,0,0,2021,9,"-8.6010558,41.1831056",1
2021-09-01,Região de Saúde Norte,"Centro Hospitalar Universitário do Porto, EPE",1821,0,1821,2021,9,"-8.6172617,41.1472498",1
2021-09-01,Região de Saúde Norte,"Unidade Local de Saúde de Matosinhos, EPE",0,7095,7095,2021,9,"-8.6745115,41.1794456",1
2021-09-01,Região de Saúde Norte,"Unidade Local de Saúde do Alto Minho, EPE",5,2,7,2021,9,"-8.8252713,41.7056054",1
2021-10-01,Região de Saúde LVT,"Centro Hospitalar Universitário Lisboa Central, EPE",5377,2121,7498,2021,10,"-9.1371248,38.7166948",3
2021-10-01,Região de Saúde LVT,"Centro Hospitalar do Oeste, EPE, EPE",5484,25853,31337,2021,10,"-9.1258493,39.4054629",3
2021-10-01,Região de Saúde Norte,"Instituto Português Oncologia do Porto, EPE",85,73,158,2021,10,"-8.6062881,41.1785642",1
2021-11-01,Região de Saúde do Centro,"Centro Hospitalar Universitário Cova da Beira, EPE",9354,21866,31220,2021,11,"-7.4922407,40.2804158",2
2021-11-01,Região de Saúde do Centro,"Centro Hospitalar Tondela-Viseu, EPE",293,79,372,2021,11,"-8.0827433,40.516364",2
2021-11-01,Região de Saúde do Centro,Centro Medicina de Reabilitação da Região Centro Rovisco Pais,1,2,3,2021,11,"-8.7707806,40.297919",2
2021-11-01,Região de Saúde do Centro,Hospital Arcebispo João Crisóstomo,92,0,92,2021,11,"-8.5933462,40.3470015",2
2021-11-01,Região de Saúde do Centro,"Unidade Local de Saúde de Castelo Branco, EPE",257,132,389,2021,11,"-7.4981271,39.8212263",2
2021-11-01,Região de Saúde LVT,"Centro Hospitalar de Setúbal, EPE",713,441,1154,2021,11,"-8.8818638,38.5283754",3
2021-11-01,Região de Saúde LVT,"Centro Hospitalar do Oeste, EPE, EPE",6121,27795,33916,2021,11,"-9.1258493,39.4054629",3
2021-11-01,Região de Saúde LVT,Centro Hospitalar Psiquiátrico de Lisboa,532,8487,9019,2021,11,"-9.1460705,38.7569771",3
2021-11-01,Região de Saúde Norte,"Centro Hospitalar Universitário do Porto, EPE",2377,0,2377,2021,11,"-8.6172617,41.1472498",1
2021-11-01,Região de Saúde Norte,"Centro Hospitalar Entre Douro e Vouga, EPE",93,41,134,2021,11,"-8.5458794,40.9293884",1
2021-11-01,Região de Saúde Norte,"Hospital da Senhora da Oliveira, Guimarães, EPE",1203,0,1203,2021,11,"-8.3086907,41.4387173",1
2021-11-01,Região de Saúde Norte,"Hospital de Braga, EPE",602,0,602,2021,11,"-8.398982,41.56785",1
2021-12-01,Região de Saúde do Alentejo,"Unidade Local de Saúde do Baixo Alentejo, EPE",2177,1498,3675,2021,12,"-7.8721227,38.014123",4
2021-12-01,Região de Saúde do Alentejo,"Unidade Local de Saúde do Litoral Alentejano, EPE",12,0,12,2021,12,"-8.6956768,38.0162314",4
2021-12-01,Região de Saúde LVT,"Centro Hospitalar Barreiro/Montijo, EPE",1157,1015,2172,2021,12,"-9.0592392,38.6554005",3
2021-12-01,Região de Saúde LVT,"Centro Hospitalar do Oeste, EPE, EPE",6673,29444,36117,2021,12,"-9.1258493,39.4054629",3
2021-12-01,Região de Saúde LVT,"Hospital Garcia de Orta, EPE",1271,12628,13899,2021,12,"-9.1822554,38.6658713",3
2022-01-01,Região de Saúde do Alentejo,"Unidade Local de Saúde do Baixo Alentejo, EPE",160,113,273,2022,1,"-7.8721227,38.014123",4
2022-01-01,Região de Saúde do Centro,"Centro Hospitalar de Leiria, EPE",28,14,42,2022,1,"-8.7982706,39.7414812",2
2022-01-01,Região de Saúde LVT,Centro Hospitalar Psiquiátrico de Lisboa,55,821,876,2022,1,"-9.1460705,38.7569771",3
2022-01-01,Região de Saúde Norte,"Centro Hospitalar Universitário de São João, EPE",0,0,0,2022,1,"-8.6010558,41.1831056",1
2022-01-01,Região de Saúde Norte,"Hospital da Senhora da Oliveira, Guimarães, EPE",84,0,84,2022,1,"-8.3086907,41.4387173",1
2022-01-01,Região de Saúde Norte,"Unidade Local de Saúde do Alto Minho, EPE",0,5,5,2022,1,"-8.8252713,41.7056054",1
2022-02-01,Região de Saúde LVT,"Centro Hospitalar Barreiro/Montijo, EPE",215,198,413,2022,2,"-9.0592392,38.6554005",3
2022-02-01,Região de Saúde LVT,"Centro Hospitalar de Setúbal, EPE",140,145,285,2022,2,"-8.8818638,38.5283754",3
2022-02-01,Região de Saúde LVT,"Centro Hospitalar Universitário de Lisboa Norte, EPE",810,163,973,2022,2,"-9.1616116,38.7500861",3
2022-02-01,Região de Saúde LVT,"Centro Hospitalar Médio Tejo, EPE",0,0,0,2022,2,"-8.5404429,39.478072",3
2022-02-01,Região de Saúde LVT,"Hospital de Vila Franca de Xira, EPE",95,2374,2469,2022,2,"-8.984506,38.977235",3
2022-02-01,Região de Saúde LVT,"Hospital Garcia de Orta, EPE",472,4188,4660,2022,2,"-9.1822554,38.6658713",3
2022-02-01,Região de Saúde Norte,"Centro Hospitalar Universitário de São João, EPE",0,0,0,2022,2,"-8.6010558,41.1831056",1
2022-02-01,Região de Saúde Norte,"Centro Hospitalar Póvoa de Varzim/Vila do Conde, EPE",76,5,81,2022,2,"-8.7589945,41.3828711",1
2022-02-01,Região de Saúde Norte,"Unidade Local de Saúde de Matosinhos, EPE",0,1486,1486,2022,2,"-8.6745115,41.1794456",1
2022-03-01,Região de Saúde do Alentejo,"Unidade Local de Saúde do Litoral Alentejano, EPE",10,0,10,2022,3,"-8.6956768,38.0162314",4
2022-03-01,Região de Saúde do Alentejo,"Unidade Local de Saúde do Norte Alentejano, EPE",225,19,244,2022,3,"-7.4263845,39.3003425",4
2022-03-01,Região de Saúde LVT,"Hospital Professor Doutor Fernando Fonseca, EPE",1058,9808,10866,2022,3,"-9.2264834,38.7422257",3
2022-03-01,Região de Saúde Norte,"Centro Hospitalar Universitário do Porto, EPE",795,0,795,2022,3,"-8.6172617,41.1472498",1
2022-03-01,Região de Saúde Norte,"Hospital de Braga, EPE",238,0,238,2022,3,"-8.398982,41.56785",1
2022-04-01,Região de Saúde do Centro,"Centro Hospitalar do Baixo Vouga, EPE",153,153,306,2022,4,"-8.6543716,40.6362453",2
2022-04-01,Região de Saúde do Centro,"Centro Hospitalar Tondela-Viseu, EPE",109,46,155,2022,4,"-8.0827433,40.516364",2
2022-04-01,Região de Saúde LVT,"Centro Hospitalar de Setúbal, EPE",312,339,651,2022,4,"-8.8818638,38.5283754",3
2022-04-01,Região de Saúde LVT,"Hospital Distrital de Santarém, EPE",1,29,30,2022,4,"-8.6937515,39.2410946",3
2022-04-01,Região de Saúde LVT,"Hospital Garcia de Orta, EPE",817,7225,8042,2022,4,"-9.1822554,38.6658713",3
2022-04-01,Região de Saúde Norte,"Centro Hospitalar Póvoa de Varzim/Vila do Conde, EPE",142,6,148,2022,4,"-8.7589945,41.3828711",1
2022-04-01,Região de Saúde Norte,"Hospital de Braga, EPE",323,0,323,2022,4,"-8.398982,41.56785",1
2022-04-01,Região de Saúde Norte,"Unidade Local de Saúde do Alto Minho, EPE",15,28,43,2022,4,"-8.8252713,41.7056054",1
2022-05-01,Região de Saúde do Centro,"Centro Hospitalar Tondela-Viseu, EPE",123,56,179,2022,5,"-8.0827433,40.516364",2
2022-05-01,Região de Saúde LVT,"Centro Hospitalar Universitário Lisboa Central, EPE",646,1477,2123,2022,5,"-9.1371248,38.7166948",3
2022-05-01,Região de Saúde LVT,"Hospital Professor Doutor Fernando Fonseca, EPE",1338,12340,13678,2022,5,"-9.2264834,38.7422257",3
2022-05-01,Região de Saúde Norte,"Centro Hospitalar Universitário do Porto, EPE",1348,0,1348,2022,5,"-8.6172617,41.1472498",1
2022-05-01,Região de Saúde Norte,"Hospital de Magalhães Lemos, EPE",0,1207,1207,2022,5,"-8.6649823,41.1764649",1
2022-06-01,Região de Saúde do Alentejo,"Unidade Local de Saúde do Baixo Alentejo, EPE",1105,539,1644,2022,6,"-7.8721227,38.014123",4
2022-06-01,Região de Saúde do Centro,"Centro Hospitalar e Universitário de Coimbra, EPE",1260,1275,2535,2022,6,"-8.4098211,40.2191523",2
2022-06-01,Região de Saúde do Centro,"Hospital Distrital da Figueira da Foz, EPE",1427,2252,3679,2022,6,"-8.8586755,40.117897",2
2022-06-01,Região de Saúde LVT,"Centro Hospitalar Barreiro/Montijo, EPE",809,1168,1977,2022,6,"-9.0592392,38.6554005",3
2022-06-01,Região de Saúde LVT,"Hospital de Vila Franca de Xira, EPE",184,6185,6369,2022,6,"-8.984506,38.977235",3
2022-06-01,Região de Saúde Norte,"Centro Hospitalar Entre Douro e Vouga, EPE",64,46,110,2022,6,"-8.5458794,40.9293884",1
2022-06-01,Região de Saúde Norte,"Unidade Local de Saúde do Alto Minho, EPE",15,34,49,2022,6,"-8.8252713,41.7056054",1
2022-07-01,Região de Saúde do Alentejo,"Unidade Local de Saúde do Baixo Alentejo, EPE",1232,629,1861,2022,7,"-7.8721227,38.014123",4
2022-07-01,Região de Saúde LVT,"Centro Hospitalar Universitário de Lisboa Norte, EPE",3829,443,4272,2022,7,"-9.1616116,38.7500861",3
2022-07-01,Região de Saúde LVT,"Centro Hospitalar Médio Tejo, EPE",0,0,0,2022,7,"-8.5404429,39.478072",3
2022-07-01,Região de Saúde LVT,Centro Hospitalar Psiquiátrico de Lisboa,278,5026,5304,2022,7,"-9.1460705,38.7569771",3
2022-07-01,Região de Saúde Norte,"Centro Hospitalar Universitário do Porto, EPE",1895,0,1895,2022,7,"-8.6172617,41.1472498",1
2022-07-01,Região de Saúde Norte,"Hospital da Senhora da Oliveira, Guimarães, EPE",675,0,675,2022,7,"-8.3086907,41.4387173",1
2022-07-01,Região de Saúde Norte,"Hospital de Braga, EPE",532,0,532,2022,7,"-8.398982,41.56785",1
2022-08-01,Região de Saúde do Centro,"Centro Hospitalar e Universitário de Coimbra, EPE",1709,1677,3386,2022,8,"-8.4098211,40.2191523",2
2022-08-01,Região de Saúde LVT,"Centro Hospitalar Universitário Lisboa Central, EPE",789,2342,3131,2022,8,"-9.1371248,38.7166948",3
2022-08-01,Região de Saúde LVT,Centro Hospitalar Psiquiátrico de Lisboa,309,5545,5854,2022,8,"-9.1460705,38.7569771",3
2022-08-01,Região de Saúde LVT,"Hospital de Vila Franca de Xira, EPE",214,6823,7037,2022,8,"-8.984506,38.977235",3
2022-09-01,Região de Saúde LVT,"Hospital Distrital de Santarém, EPE",5,65,70,2022,9,"-8.6937515,39.2410946",3
2022-09-01,Região de Saúde Norte,"Centro Hospitalar Vila Nova de Gaia/Espinho, EPE",544,0,544,2022,9,"-8.5972617,41.1094138",1
2022-10-01,Região de Saúde do Alentejo,"Hospital Espírito Santo de Évora, EPE",1086,193,1279,2022,10,"-7.9032848,38.5684861",4
2022-10-01,Região de Saúde do Alentejo,"Unidade Local de Saúde do Norte Alentejano, EPE",555,175,730,2022,10,"-7.4263845,39.3003425",4
2022-10-01,Região de Saúde do Centro,"Centro Hospitalar do Baixo Vouga, EPE",423,352,775,2022,10,"-8.6543716,40.6362453",2
2022-10-01,Região de Saúde do Centro,"Centro Hospitalar e Universitário de Coimbra, EPE",2560,2205,4765,2022,10,"-8.4098211,40.2191523",2
2022-10-01,Região de Saúde do Centro,"Centro Hospitalar Tondela-Viseu, EPE",228,91,319,2022,10,"-8.0827433,40.516364",2
2022-10-01,Região de Saúde LVT,"Centro Hospitalar Médio Tejo, EPE",0,0,0,2022,10,"-8.5404429,39.478072",3
2022-10-01,Região de Saúde LVT,"Hospital Garcia de Orta, EPE",1639,15117,16756,2022,10,"-9.1822554,38.6658713",3
2022-10-01,Região de Saúde Norte,"Centro Hospitalar Entre Douro e Vouga, EPE",81,122,203,2022,10,"-8.5458794,40.9293884",1
2022-11-01,Região de Saúde do Alentejo,"Unidade Local de Saúde do Baixo Alentejo, EPE",1519,857,2376,2022,11,"-7.8721227,38.014123",4
2022-11-01,Região de Saúde do Centro,"Centro Hospitalar Universitário Cova da Beira, EPE",5599,14579,20178,2022,11,"-7.4922407,40.2804158",2
2022-11-01,Região de Saúde do Centro,Centro Medicina de Reabilitação da Região Centro Rovisco Pais,53,11,64,2022,11,"-8.7707806,40.297919",2
2022-11-01,Região de Saúde do Centro,Hospital Arcebispo João Crisóstomo,59,0,59,2022,11,"-8.5933462,40.3470015",2
2022-11-01,Região de Saúde LVT,"Centro Hospitalar Universitário Lisboa Central, EPE",989,3590,4579,2022,11,"-9.1371248,38.7166948",3
2022-11-01,Região de Saúde LVT,"Centro Hospitalar Universitário de Lisboa Norte, EPE",6397,521,6918,2022,11,"-9.1616116,38.7500861",3
2022-11-01,Região de Saúde LVT,Centro Hospitalar Psiquiátrico de Lisboa,427,7656,8083,2022,11,"-9.1460705,38.7569771",3
2022-11-01,Região de Saúde LVT,"Hospital de Vila Franca de Xira, EPE",262,6835,7097,2022,11,"-8.984506,38.977235",3
2022-11-01,Região de Saúde Norte,"Centro Hospitalar Universitário do Porto, EPE",3214,0,3214,2022,11,"-8.6172617,41.1472498",1
2022-11-01,Região de Saúde Norte,"Centro Hospitalar Vila Nova de Gaia/Espinho, EPE",654,0,654,2022,11,"-8.5972617,41.1094138",1
2022-11-01,Região de Saúde Norte,"Unidade Local de Saúde do Alto Minho, EPE",16,93,109,2022,11,"-8.8252713,41.7056054",1
2022-12-01,Região de Saúde do Centro,"Centro Hospitalar e Universitário de Coimbra, EPE",3551,2852,6403,2022,12,"-8.4098211,40.2191523",2
2022-12-01,Região de Saúde do Centro,"Centro Hospitalar Tondela-Viseu, EPE",280,116,396,2022,12,"-8.0827433,40.516364",2
2022-12-01,Região de Saúde do Centro,"Hospital Distrital da Figueira da Foz, EPE",1863,3417,5280,2022,12,"-8.8586755,40.117897",2
2022-12-01,Região de Saúde LVT,Centro Hospitalar Psiquiátrico de Lisboa,437,8174,8611,2022,12,"-9.1460705,38.7569771",3
2022-12-01,Região de Saúde Norte,"Centro Hospitalar Universitário do Porto, EPE",3403,0,3403,2022,12,"-8.6172617,41.1472498",1
2022-12-01,Região de Saúde Norte,"Centro Hospitalar Entre Douro e Vouga, EPE",165,238,403,2022,12,"-8.5458794,40.9293884",1
2022-12-01,Região de Saúde Norte,"Centro Hospitalar Trás-os-Montes e Alto Douro, EPE",289,0,289,2022,12,"-7.7515252,41.3031784",1
2022-12-01,Região de Saúde Norte,"Centro Hospitalar Vila Nova de Gaia/Espinho, EPE",694,0,694,2022,12,"-8.5972617,41.1094138",1
2023-01-01,Região de Saúde do Alentejo,"Hospital Espírito Santo de Évora, EPE",137,24,161,2023,1,"-7.9032848,38.5684861",4
2023-01-01,Região de Saúde do Centro,Hospital Arcebispo João Crisóstomo,1,0,1,2023,1,"-8.5933462,40.3470015",2
2023-01-01,Região de Saúde do Centro,"Unidade Local de Saúde de Castelo Branco, EPE",303,487,790,2023,1,"-7.4981271,39.8212263",2
2023-01-01,Região de Saúde LVT,"Centro Hospitalar do Oeste, EPE, EPE",367,850,1217,2023,1,"-9.1258493,39.4054629",3
2023-01-01,Região de Saúde LVT,"Centro Hospitalar Universitário de Lisboa Norte, EPE",612,2,614,2023,1,"-9.1616116,38.7500861",3
2023-01-01,Região de Saúde Norte,"Hospital da Senhora da Oliveira, Guimarães, EPE",89,0,89,2023,1,"-8.3086907,41.4387173",1
2023-01-01,Região de Saúde Norte,"Unidade Local de Saúde de Matosinhos, EPE",0,661,661,2023,1,"-8.6745115,41.1794456",1
2023-02-01,Região de Saúde do Alentejo,"Hospital Espírito Santo de Évora, EPE",196,41,237,2023,2,"-7.9032848,38.5684861",4
2023-02-01,Região de Saúde do Centro,"Centro Hospitalar de Leiria, EPE",59,54,113,2023,2,"-8.7982706,39.7414812",2
2023-02-01,Região de Saúde do Centro,"Unidade Local de Saúde de Castelo Branco, EPE",566,886,1452,2023,2,"-7.4981271,39.8212263",2
2023-02-01,Região de Saúde LVT,"Centro Hospitalar de Lisboa Ocidental, EPE",44,354,398,2023,2,"-9.216985,38.708454",3
2023-02-01,Região de Saúde LVT,"Centro Hospitalar Médio Tejo, EPE",0,0,0,2023,2,"-8.5404429,39.478072",3
2023-02-01,Região de Saúde LVT,"Hospital de Vila Franca de Xira, EPE",28,1515,1543,2023,2,"-8.984506,38.977235",3
2023-02-01,Região de Saúde LVT,"Hospital Distrital de Santarém, EPE",1,29,30,2023,2,"-8.6937515,39.2410946",3
2023-02-01,Região de Saúde LVT,"Hospital Professor Doutor Fernando Fonseca, EPE",556,4995,5551,2023,2,"-9.2264834,38.7422257",3
2023-02-01,Região de Saúde LVT,"Hospital Garcia de Orta, EPE",125,1647,1772,2023,2,"-9.1822554,38.6658713",3
2023-02-01,Região de Saúde Norte,"Centro Hospitalar Entre Douro e Vouga, EPE",12,23,35,2023,2,"-8.5458794,40.9293884",1
2023-02-01,Região de Saúde Norte,"Hospital de Braga, EPE",138,0,138,2023,2,"-8.398982,41.56785",1
2023-02-01,Região de Saúde Norte,"Unidade Local de Saúde de Matosinhos, EPE",0,1307,1307,2023,2,"-8.6745115,41.1794456",1
2023-03-01,Região de Saúde do Alentejo,"Unidade Local de Saúde do Norte Alentejano, EPE",122,260,382,2023,3,"-7.4263845,39.3003425",4
2023-03-01,Região de Saúde do Algarve,"Centro Hospitalar Universitário do Algarve,EPE",0,0,0,2023,3,"-7.9281554,37.0238973",5
2023-03-01,Região de Saúde do Centro,"Centro Hospitalar do Baixo Vouga, EPE",151,132,283,2023,3,"-8.6543716,40.6362453",2
2023-03-01,Região de Saúde do Centro,Centro Medicina de Reabilitação da Região Centro Rovisco Pais,48,33,81,2023,3,"-8.7707806,40.297919",2
2023-03-01,Região de Saúde do Centro,Hospital Arcebispo João Crisóstomo,1,0,1,2023,3,"-8.5933462,40.3470015",2
2023-03-01,Região de Saúde LVT,"Centro Hospitalar de Setúbal, EPE",62,75,137,2023,3,"-8.8818638,38.5283754",3
2023-03-01,Região de Saúde LVT,"Centro Hospitalar Universitário de Lisboa Norte, EPE",1737,11,1748,2023,3,"-9.1616116,38.7500861",3
2023-03-01,Região de Saúde LVT,Centro Hospitalar Psiquiátrico de Lisboa,142,1877,2019,2023,3,"-9.1460705,38.7569771",3
2023-03-01,Região de Saúde Norte,"Centro Hospitalar Entre Douro e Vouga, EPE",14,35,49,2023,3,"-8.5458794,40.9293884",1
2023-03-01,Região de Saúde Norte,"Unidade Local de Saúde de Matosinhos, EPE",0,2110,2110,2023,3,"-8.6745115,41.1794456",1
2023-04-01,Região de Saúde do Alentejo,"Unidade Local de Saúde do Baixo Alentejo, EPE",129,201,330,2023,4,"-7.8721227,38.014123",4
2023-04-01,Região de Saúde do Alentejo,"Unidade Local de Saúde do Litoral Alentejano, EPE",7,8,15,2023,4,"-8.6956768,38.0162314",4
2023-04-01,Região de Saúde do Centro,"Hospital Distrital da Figueira da Foz, EPE",334,857,1191,2023,4,"-8.8586755,40.117897",2
2023-04-01,Região de Saúde do Centro,"Instituto Português Oncologia de Coimbra, EPE",0,7,7,2023,4,"-8.4103814,40.2162514",2
2023-04-01,Região de Saúde LVT,"Centro Hospitalar Médio Tejo, EPE",0,0,0,2023,4,"-8.5404429,39.478072",3
2023-04-01,Região de Saúde LVT,Centro Hospitalar Psiquiátrico de Lisboa,174,2415,2589,2023,4,"-9.1460705,38.7569771",3
2023-04-01,Região de Saúde LVT,"Hospital Distrital de Santarém, EPE",3,109,112,2023,4,"-8.6937515,39.2410946",3
2023-04-01,Região de Saúde Norte,"Centro Hospitalar Trás-os-Montes e Alto Douro, EPE",71,0,71,2023,4,"-7.7515252,41.3031784",1
2023-04-01,Região de Saúde Norte,"Centro Hospitalar Universitário de Santo António, EPE",685,785,1470,2023,4,"-8.6172617,41.1472498",1
2023-05-01,Região de Saúde do Alentejo,"Hospital Espírito Santo de Évora, EPE",444,116,560,2023,5,"-7.9032848,38.5684861",4
2023-05-01,Região de Saúde do Alentejo,"Unidade Local de Saúde do Litoral Alentejano, EPE",7,8,15,2023,5,"-8.6956768,38.0162314",4
2023-05-01,Região de Saúde do Alentejo,"Unidade Local de Saúde do Norte Alentejano, EPE",283,353,636,2023,5,"-7.4263845,39.3003425",4
2023-05-01,Região de Saúde LVT,Centro Hospitalar Psiquiátrico de Lisboa,200,2933,3133,2023,5,"-9.1460705,38.7569771",3
2023-05-01,Região de Saúde LVT,"Hospital Distrital de Santarém, EPE",3,264,267,2023,5,"-8.6937515,39.2410946",3
2023-05-01,Região de Saúde LVT,"Hospital Professor Doutor Fernando Fonseca, EPE",1407,12332,13739,2023,5,"-9.2264834,38.7422257",3
2023-05-01,Região de Saúde Norte,"Centro Hospitalar do Médio Ave, EPE",112,2195,2307,2023,5,"-8.4802503,41.3423984",1
2023-05-01,Região de Saúde Norte,"Centro Hospitalar Trás-os-Montes e Alto Douro, EPE",112,0,112,2023,5,"-7.7515252,41.3031784",1
2023-06-01,Região de Saúde do Algarve,"Centro Hospitalar Universitário do Algarve,EPE",0,0,0,2023,6,"-7.9281554,37.0238973",5
2023-06-01,Região de Saúde LVT,"Centro Hospitalar do Oeste, EPE, EPE",1828,5016,6844,2023,6,"-9.1258493,39.4054629",3
2023-06-01,Região de Saúde LVT,"Hospital Distrital de Santarém, EPE",8,483,491,2023,6,"-8.6937515,39.2410946",3
2023-06-01,Região de Saúde LVT,"Hospital Professor Doutor Fernando Fonseca, EPE",1715,14744,16459,2023,6,"-9.2264834,38.7422257",3
2023-06-01,Região de Saúde Norte,"Hospital da Senhora da Oliveira, Guimarães, EPE",613,0,613,2023,6,"-8.3086907,41.4387173",1
2023-07-01,Região de Saúde do Alentejo,"Hospital Espírito Santo de Évora, EPE",529,151,680,2023,7,"-7.9032848,38.5684861",4
2023-07-01,Região de Saúde do Alentejo,"Unidade Local de Saúde do Baixo Alentejo, EPE",225,483,708,2023,7,"-7.8721227,38.014123",4
2023-07-01,Região de Saúde do Centro,Hospital Arcebispo João Crisóstomo,14,0,14,2023,7,"-8.5933462,40.3470015",2
2023-07-01,Região de Saúde LVT,"Hospital Distrital de Santarém, EPE",8,623,631,2023,7,"-8.6937515,39.2410946",3
2023-07-01,Região de Saúde Norte,"Centro Hospitalar Póvoa de Varzim/Vila do Conde, EPE",277,62,339,2023,7,"-8.7589945,41.3828711",1
2023-07-01,Região de Saúde Norte,"Centro Hospitalar Trás-os-Montes e Alto Douro, EPE",166,0,166,2023,7,"-7.7515252,41.3031784",1
2023-07-01,Região de Saúde Norte,"Centro Hospitalar Universitário de Santo António, EPE",1474,1351,2825,2023,7,"-8.6172617,41.1472498",1
2023-08-01,Região de Saúde do Centro,"Centro Hospitalar Universitário Cova da Beira, EPE",3051,9066,12117,2023,8,"-7.4922407,40.2804158",2
2023-08-01,Região de Saúde do Centro,Hospital Arcebispo João Crisóstomo,17,0,17,2023,8,"-8.5933462,40.3470015",2
2023-08-01,Região de Saúde do Centro,"Hospital Distrital da Figueira da Foz, EPE",664,1650,2314,2023,8,"-8.8586755,40.117897",2
2023-08-01,Região de Saúde LVT,"Centro Hospitalar do Oeste, EPE, EPE",3504,6089,9593,2023,8,"-9.1258493,39.4054629",3
2023-08-01,Região de Saúde LVT,"Centro Hospitalar Universitário de Lisboa Norte, EPE",4876,42,4918,2023,8,"-9.1616116,38.7500861",3
2023-08-01,Região de Saúde LVT,"Hospital de Vila Franca de Xira, EPE",153,0,153,2023,8,"-8.984506,38.977235",3
2023-08-01,Região de Saúde LVT,"Hospital Professor Doutor Fernando Fonseca, EPE",2241,19184,21425,2023,8,"-9.2264834,38.7422257",3
2023-08-01,Região de Saúde LVT,"Hospital Garcia de Orta, EPE",419,7078,7497,2023,8,"-9.1822554,38.6658713",3
2023-09-01,Região de Saúde do Algarve,"Centro Hospitalar Universitário do Algarve,EPE",0,0,0,2023,9,"-7.9281554,37.0238973",5
2023-09-01,Região de Saúde do Centro,"Centro Hospitalar do Baixo Vouga, EPE",355,384,739,2023,9,"-8.6543716,40.6362453",2
2023-09-01,Região de Saúde do Centro,Centro Medicina de Reabilitação da Região Centro Rovisco Pais,164,68,232,2023,9,"-8.7707806,40.297919",2
2023-09-01,Região de Saúde do Centro,"Hospital Distrital da Figueira da Foz, EPE",718,1836,2554,2023,9,"-8.8586755,40.117897",2
2023-09-01,Região de Saúde LVT,"Centro Hospitalar Barreiro/Montijo, EPE",2126,2520,4646,2023,9,"-9.0592392,38.6554005",3
2023-09-01,Região de Saúde LVT,"Centro Hospitalar de Setúbal, EPE",141,366,507,2023,9,"-8.8818638,38.5283754",3
2023-09-01,Região de Saúde Norte,"Centro Hospitalar Trás-os-Montes e Alto Douro, EPE",189,0,189,2023,9,"-7.7515252,41.3031784",1
2023-09-01,Região de Saúde Norte,"Centro Hospitalar Universitário de Santo António, EPE",1919,1682,3601,2023,9,"-8.6172617,41.1472498",1
2023-10-01,Região de Saúde do Alentejo,"Unidade Local de Saúde do Litoral Alentejano, EPE",69,11,80,2023,10,"-8.6956768,38.0162314",4
2023-10-01,Região de Saúde do Centro,"Centro Hospitalar e Universitário de Coimbra, EPE",5801,2936,8737,2023,10,"-8.4098211,40.2191523",2
2023-10-01,Região de Saúde do Centro,"Centro Hospitalar Tondela-Viseu, EPE",380,101,481,2023,10,"-8.0827433,40.516364",2
2023-10-01,Região de Saúde do Centro,Hospital Arcebispo João Crisóstomo,29,0,29,2023,10,"-8.5933462,40.3470015",2
2023-10-01,Região de Saúde LVT,"Centro Hospitalar Barreiro/Montijo, EPE",2341,2866,5207,2023,10,"-9.0592392,38.6554005",3
2023-10-01,Região de Saúde LVT,Centro Hospitalar Psiquiátrico de Lisboa,397,5650,6047,2023,10,"-9.1460705,38.7569771",3
2023-10-01,Região de Saúde LVT,"Hospital Distrital de Santarém, EPE",14,1181,1195,2023,10,"-8.6937515,39.2410946",3
2023-10-01,Região de Saúde Norte,"Centro Hospitalar Póvoa de Varzim/Vila do Conde, EPE",439,96,535,2023,10,"-8.7589945,41.3828711",1
2023-10-01,Região de Saúde Norte,"Centro Hospitalar Trás-os-Montes e Alto Douro, EPE",228,0,228,2023,10,"-7.7515252,41.3031784",1
2023-10-01,Região de Saúde Norte,"Hospital de Braga, EPE",458,0,458,2023,10,"-8.398982,41.56785",1
2023-10-01,Região de Saúde Norte,"Instituto Português Oncologia do Porto, EPE",136,149,285,2023,10,"-8.6062881,41.1785642",1
2023-11-01,Região de Saúde do Alentejo,"Hospital Espírito Santo de Évora, EPE",799,221,1020,2023,11,"-7.9032848,38.5684861",4
2023-11-01,Região de Saúde do Centro,"Centro Hospitalar Universitário Cova da Beira, EPE",4193,12639,16832,2023,11,"-7.4922407,40.2804158",2
2023-11-01,Região de Saúde do Centro,"Centro Hospitalar do Baixo Vouga, EPE",446,460,906,2023,11,"-8.6543716,40.6362453",2
2023-11-01,Região de Saúde LVT,"Hospital Distrital de Santarém, EPE",18,1413,1431,2023,11,"-8.6937515,39.2410946",3
2023-11-01,Região de Saúde LVT,"Hospital Professor Doutor Fernando Fonseca, EPE",2956,24038,26994,2023,11,"-9.2264834,38.7422257",3
2023-11-01,Região de Saúde Norte,"Centro Hospitalar do Médio Ave, EPE",245,4487,4732,2023,11,"-8.4802503,41.3423984",1
2023-11-01,Região de Saúde Norte,"Centro Hospitalar Entre Douro e Vouga, EPE",182,152,334,2023,11,"-8.5458794,40.9293884",1
2023-12-01,Região de Saúde do Centro,Centro Medicina de Reabilitação da Região Centro Rovisco Pais,222,104,326,2023,12,"-8.7707806,40.297919",2
2023-12-01,Região de Saúde do Centro,Hospital Arcebispo João Crisóstomo,54,0,54,2023,12,"-8.5933462,40.3470015",2
2023-12-01,Região de Saúde do Centro,"Instituto Português Oncologia de Coimbra, EPE",0,27,27,2023,12,"-8.4103814,40.2162514",2
2023-12-01,Região de Saúde do Centro,"Unidade Local de Saúde de Castelo Branco, EPE",3272,5500,8772,2023,12,"-7.4981271,39.8212263",2
2023-12-01,Região de Saúde LVT,"Centro Hospitalar de Lisboa Ocidental, EPE",757,2738,3495,2023,12,"-9.216985,38.708454",3
2023-12-01,Região de Saúde LVT,"Centro Hospitalar do Oeste, EPE, EPE",4776,9336,14112,2023,12,"-9.1258493,39.4054629",3
2023-12-01,Região de Saúde LVT,"Hospital Distrital de Santarém, EPE",20,1656,1676,2023,12,"-8.6937515,39.2410946",3
2023-12-01,Região de Saúde Norte,"Centro Hospitalar Vila Nova de Gaia/Espinho, EPE",323,0,323,2023,12,"-8.5972617,41.1094138",1
2023-12-01,Região de Saúde Norte,"Instituto Português Oncologia do Porto, EPE",153,165,318,2023,12,"-8.6062881,41.1785642",1
2013-01-01,Região de Saúde do Alentejo,"Unidade Local de Saúde do Litoral Alentejano, EPE",0,0,0,2013,1,"-8.6956768,38.0162314",4
2013-01-01,Região de Saúde do Centro,"Centro Hospitalar Tondela-Viseu, EPE",34,18,52,2013,1,"-8.0827433,40.516364",2
2013-02-01,Região de Saúde LVT,"Hospital Professor Doutor Fernando Fonseca, EPE",0,0,0,2013,2,"-9.2264834,38.7422257",3
2013-03-01,Região de Saúde do Centro,"Centro Hospitalar Tondela-Viseu, EPE",79,0,79,2013,3,"-8.0827433,40.516364",2
2013-04-01,Região de Saúde do Centro,"Centro Hospitalar Tondela-Viseu, EPE",97,86,183,2013,4,"-8.0827433,40.516364",2
2013-04-01,Região de Saúde LVT,"Hospital Garcia de Orta, EPE",0,0,0,2013,4,"-9.1822554,38.6658713",3
2013-05-01,Região de Saúde do Centro,"Centro Hospitalar Tondela-Viseu, EPE",136,104,240,2013,5,"-8.0827433,40.516364",2
2013-05-01,Região de Saúde do Centro,"Unidade Local de Saúde da Guarda, EPE",94,23,117,2013,5,"-7.2734793,40.5309916",2
2013-05-01,Região de Saúde do Centro,"Unidade Local de Saúde de Castelo Branco, EPE",69,45,114,2013,5,"-7.4981271,39.8212263",2
2013-06-01,Região de Saúde do Centro,"Centro Hospitalar do Baixo Vouga, EPE",246,257,503,2013,6,"-8.6543716,40.6362453",2
2013-06-01,Região de Saúde do Centro,"Unidade Local de Saúde de Castelo Branco, EPE",73,53,126,2013,6,"-7.4981271,39.8212263",2
2013-06-01,Região de Saúde LVT,"Centro Hospitalar de Setúbal, EPE",0,0,0,2013,6,"-8.8818638,38.5283754",3
2013-06-01,Região de Saúde Norte,"Centro Hospitalar Trás-os-Montes e Alto Douro, EPE",289,0,289,2013,6,"-7.7515252,41.3031784",1
2013-07-01,Região de Saúde do Centro,"Centro Hospitalar do Baixo Vouga, EPE",266,284,550,2013,7,"-8.6543716,40.6362453",2
2013-07-01,Região de Saúde do Centro,"Centro Hospitalar e Universitário de Coimbra, EPE",1165,802,1967,2013,7,"-8.4098211,40.2191523",2
2013-08-01,Região de Saúde do Centro,"Centro Hospitalar do Baixo Vouga, EPE",324,287,611,2013,8,"-8.6543716,40.6362453",2
2013-08-01,Região de Saúde do Centro,"Centro Hospitalar Tondela-Viseu, EPE",191,158,349,2013,8,"-8.0827433,40.516364",2
2013-08-01,Região de Saúde Norte,"Centro Hospitalar Trás-os-Montes e Alto Douro, EPE",362,0,362,2013,8,"-7.7515252,41.3031784",1
2013-08-01,Região de Saúde Norte,"Unidade Local de Saúde de Matosinhos, EPE",790,0,790,2013,8,"-8.6745115,41.1794456",1
2013-09-01,Região de Saúde do Alentejo,"Unidade Local de Saúde do Norte Alentejano, EPE",661,729,1390,2013,9,"-7.4263845,39.3003425",4
2013-09-01,Região de Saúde do Centro,"Centro Hospitalar do Baixo Vouga, EPE",358,349,707,2013,9,"-8.6543716,40.6362453",2
2013-10-01,Região de Saúde do Alentejo,"Hospital Espírito Santo de Évora, EPE",937,482,1419,2013,10,"-7.9032848,38.5684861",4
2013-10-01,Região de Saúde LVT,"Centro Hospitalar de Setúbal, EPE",0,0,0,2013,10,"-8.8818638,38.5283754",3
2013-11-01,Região de Saúde do Algarve,"Centro Hospitalar Universitário do Algarve,EPE",602,110,712,2013,11,"-7.9281554,37.0238973",5
2013-11-01,Região de Saúde LVT,"Hospital Professor Doutor Fernando Fonseca, EPE",0,0,0,2013,11,"-9.2264834,38.7422257",3
2013-11-01,Região de Saúde Norte,"Centro Hospitalar Universitário do Porto, EPE",23,0,23,2013,11,"-8.6172617,41.1472498",1
2013-12-01,Região de Saúde do Alentejo,"Unidade Local de Saúde do Norte Alentejano, EPE",935,979,1914,2013,12,"-7.4263845,39.3003425",4
2013-12-01,Região de Saúde do Centro,"Unidade Local de Saúde de Castelo Branco, EPE",108,107,215,2013,12,"-7.4981271,39.8212263",2
2013-12-01,Região de Saúde Norte,"Centro Hospitalar Universitário do Porto, EPE",39,0,39,2013,12,"-8.6172617,41.1472498",1
2014-01-01,Região de Saúde do Centro,"Centro Hospitalar Universitário Cova da Beira, EPE",31,30,61,2014,1,"-7.4922407,40.2804158",2
2014-01-01,Região de Saúde do Centro,"Centro Hospitalar Tondela-Viseu, EPE",29,24,53,2014,1,"-8.0827433,40.516364",2
2014-01-01,Região de Saúde Norte,"Centro Hospitalar Trás-os-Montes e Alto Douro, EPE",47,0,47,2014,1,"-7.7515252,41.3031784",1
2014-02-01,Região de Saúde do Alentejo,"Unidade Local de Saúde do Baixo Alentejo, EPE",8,0,8,2014,2,"-7.8721227,38.014123",4
2014-02-01,Região de Saúde do Alentejo,"Unidade Local de Saúde do Norte Alentejano, EPE",93,182,275,2014,2,"-7.4263845,39.3003425",4
2014-02-01,Região de Saúde Norte,"Centro Hospitalar Trás-os-Montes e Alto Douro, EPE",84,0,84,2014,2,"-7.7515252,41.3031784",1
2014-03-01,Região de Saúde do Alentejo,"Unidade Local de Saúde do Norte Alentejano, EPE",137,265,402,2014,3,"-7.4263845,39.3003425",4
2014-03-01,Região de Saúde do Centro,"Unidade Local de Saúde de Castelo Branco, EPE",70,35,105,2014,3,"-7.4981271,39.8212263",2
2014-04-01,Região de Saúde do Alentejo,"Hospital Espírito Santo de Évora, EPE",449,212,661,2014,4,"-7.9032848,38.5684861",4
2014-04-01,Região de Saúde do Centro,"Unidade Local de Saúde da Guarda, EPE",59,12,71,2014,4,"-7.2734793,40.5309916",2
2014-04-01,Região de Saúde LVT,"Hospital Professor Doutor Fernando Fonseca, EPE",0,0,0,2014,4,"-9.2264834,38.7422257",3
2014-05-01,Região de Saúde do Alentejo,"Unidade Local de Saúde do Baixo Alentejo, EPE",31,15,46,2014,5,"-7.8721227,38.014123",4
2014-06-01,Região de Saúde do Algarve,"Centro Hospitalar Universitário do Algarve,EPE",477,46,523,2014,6,"-7.9281554,37.0238973",5
2014-06-01,Região de Saúde do Centro,"Centro Hospitalar do Baixo Vouga, EPE",269,297,566,2014,6,"-8.6543716,40.6362453",2
2014-06-01,Região de Saúde do Centro,"Unidade Local de Saúde de Castelo Branco, EPE",102,70,172,2014,6,"-7.4981271,39.8212263",2
2014-06-01,Região de Saúde LVT,"Hospital Professor Doutor Fernando Fonseca, EPE",0,0,0,2014,6,"-9.2264834,38.7422257",3
2014-06-01,Região de Saúde Norte,"Centro Hospitalar Universitário do Porto, EPE",177,0,177,2014,6,"-8.6172617,41.1472498",1
2014-07-01,Região de Saúde do Centro,"Unidade Local de Saúde da Guarda, EPE",135,25,160,2014,7,"-7.2734793,40.5309916",2
2014-08-01,Região de Saúde do Centro,"Centro Hospitalar Universitário Cova da Beira, EPE",203,91,294,2014,8,"-7.4922407,40.2804158",2
2014-08-01,Região de Saúde do Centro,"Centro Hospitalar e Universitário de Coimbra, EPE",1440,989,2429,2014,8,"-8.4098211,40.2191523",2
2014-08-01,Região de Saúde do Centro,"Centro Hospitalar Tondela-Viseu, EPE",195,191,386,2014,8,"-8.0827433,40.516364",2
2014-08-01,Região de Saúde do Centro,"Unidade Local de Saúde da Guarda, EPE",135,28,163,2014,8,"-7.2734793,40.5309916",2
2014-08-01,Região de Saúde Norte,"Unidade Local de Saúde de Matosinhos, EPE",1371,0,1371,2014,8,"-8.6745115,41.1794456",1
2014-09-01,Região de Saúde do Alentejo,"Hospital Espírito Santo de Évora, EPE",888,392,1280,2014,9,"-7.9032848,38.5684861",4
2014-09-01,Região de Saúde LVT,"Centro Hospitalar do Oeste, EPE",2,12,14,2014,9,"-9.1258493,39.4054629",3
2014-10-01,Região de Saúde do Alentejo,"Hospital Espírito Santo de Évora, EPE",1008,449,1457,2014,10,"-7.9032848,38.5684861",4
2014-10-01,Região de Saúde do Algarve,"Centro Hospitalar Universitário do Algarve,EPE",846,81,927,2014,10,"-7.9281554,37.0238973",5
2014-10-01,Região de Saúde do Centro,"Centro Hospitalar e Universitário de Coimbra, EPE",1614,1133,2747,2014,10,"-8.4098211,40.2191523",2
2014-10-01,Região de Saúde LVT,"Hospital Professor Doutor Fernando Fonseca, EPE",0,0,0,2014,10,"-9.2264834,38.7422257",3
2014-11-01,Região de Saúde do Algarve,"Centro Hospitalar Universitário do Algarve,EPE",942,96,1038,2014,11,"-7.9281554,37.0238973",5
2014-11-01,Região de Saúde LVT,"Centro Hospitalar do Oeste, EPE",3,15,18,2014,11,"-9.1258493,39.4054629",3
2014-11-01,Região de Saúde LVT,"Hospital Professor Doutor Fernando Fonseca, EPE",0,0,0,2014,11,"-9.2264834,38.7422257",3
2014-12-01,Região de Saúde do Alentejo,"Hospital Espírito Santo de Évora, EPE",1208,529,1737,2014,12,"-7.9032848,38.5684861",4
2014-12-01,Região de Saúde LVT,"Centro Hospitalar de Setúbal, EPE",0,0,0,2014,12,"-8.8818638,38.5283754",3
2015-01-01,Região de Saúde do Centro,"Centro Hospitalar Universitário Cova da Beira, EPE",23,7,30,2015,1,"-7.4922407,40.2804158",2
2015-01-01,Região de Saúde LVT,"Centro Hospitalar de Setúbal, EPE",0,0,0,2015,1,"-8.8818638,38.5283754",3
2015-01-01,Região de Saúde LVT,"Hospital Professor Doutor Fernando Fonseca, EPE",0,0,0,2015,1,"-9.2264834,38.7422257",3
2015-02-01,Região de Saúde do Alentejo,"Unidade Local de Saúde do Baixo Alentejo, EPE",13,8,21,2015,2,"-7.8721227,38.014123",4
2015-02-01,Região de Saúde do Centro,"Centro Hospitalar Universitário Cova da Beira, EPE",42,11,53,2015,2,"-7.4922407,40.2804158",2
2015-02-01,Região de Saúde do Centro,"Centro Hospitalar Tondela-Viseu, EPE",63,102,165,2015,2,"-8.0827433,40.516364",2
2015-02-01,Região de Saúde Norte,"Centro Hospitalar Trás-os-Montes e Alto Douro, EPE",85,0,85,2015,2,"-7.7515252,41.3031784",1
2015-02-01,Região de Saúde Norte,"Unidade Local de Saúde de Matosinhos, EPE",246,0,246,2015,2,"-8.6745115,41.1794456",1
2015-03-01,Região de Saúde do Alentejo,"Unidade Local de Saúde do Baixo Alentejo, EPE",24,15,39,2015,3,"-7.8721227,38.014123",4
2015-03-01,Região de Saúde do Centro,"Centro Hospitalar e Universitário de Coimbra, EPE",473,403,876,2015,3,"-8.4098211,40.2191523",2
2015-03-01,Região de Saúde do Centro,"Centro Hospitalar Tondela-Viseu, EPE",72,102,174,2015,3,"-8.0827433,40.516364",2
2015-03-01,Região de Saúde Norte,"Centro Hospitalar Universitário do Porto, EPE",101,0,101,2015,3,"-8.6172617,41.1472498",1
2015-04-01,Região de Saúde do Alentejo,"Unidade Local de Saúde do Baixo Alentejo, EPE",31,22,53,2015,4,"-7.8721227,38.014123",4
2015-04-01,Região de Saúde do Centro,"Centro Hospitalar Tondela-Viseu, EPE",110,110,220,2015,4,"-8.0827433,40.516364",2
2015-04-01,Região de Saúde LVT,"Centro Hospitalar de Setúbal, EPE",0,0,0,2015,4,"-8.8818638,38.5283754",3
2015-05-01,Região de Saúde do Alentejo,"Unidade Local de Saúde do Baixo Alentejo, EPE",40,28,68,2015,5,"-7.8721227,38.014123",4
2015-05-01,Região de Saúde do Algarve,"Centro Hospitalar Universitário do Algarve,EPE",516,52,568,2015,5,"-7.9281554,37.0238973",5
2015-05-01,Região de Saúde do Centro,"Centro Hospitalar Universitário Cova da Beira, EPE",138,43,181,2015,5,"-7.4922407,40.2804158",2
2015-05-01,Região de Saúde do Centro,"Centro Hospitalar e Universitário de Coimbra, EPE",888,667,1555,2015,5,"-8.4098211,40.2191523",2
2015-06-01,Região de Saúde do Centro,"Unidade Local de Saúde de Castelo Branco, EPE",76,73,149,2015,6,"-7.4981271,39.8212263",2
2015-06-01,Região de Saúde LVT,"Centro Hospitalar de Setúbal, EPE",0,0,0,2015,6,"-8.8818638,38.5283754",3
2015-06-01,Região de Saúde LVT,"Hospital Professor Doutor Fernando Fonseca, EPE",0,0,0,2015,6,"-9.2264834,38.7422257",3
2015-06-01,Região de Saúde Norte,"Centro Hospitalar Trás-os-Montes e Alto Douro, EPE",185,0,185,2015,6,"-7.7515252,41.3031784",1
2015-07-01,Região de Saúde do Alentejo,"Unidade Local de Saúde do Baixo Alentejo, EPE",48,31,79,2015,7,"-7.8721227,38.014123",4
2015-07-01,Região de Saúde do Centro,"Centro Hospitalar e Universitário de Coimbra, EPE",1239,999,2238,2015,7,"-8.4098211,40.2191523",2
2015-07-01,Região de Saúde do Centro,"Centro Hospitalar Tondela-Viseu, EPE",191,173,364,2015,7,"-8.0827433,40.516364",2
2015-07-01,Região de Saúde Norte,"Unidade Local de Saúde de Matosinhos, EPE",1118,0,1118,2015,7,"-8.6745115,41.1794456",1
2015-08-01,Região de Saúde do Alentejo,"Hospital Espírito Santo de Évora, EPE",809,377,1186,2015,8,"-7.9032848,38.5684861",4
2015-08-01,Região de Saúde Norte,"Centro Hospitalar Universitário do Porto, EPE",284,0,284,2015,8,"-8.6172617,41.1472498",1
2015-08-01,Região de Saúde Norte,"Centro Hospitalar Trás-os-Montes e Alto Douro, EPE",185,0,185,2015,8,"-7.7515252,41.3031784",1
2015-09-01,Região de Saúde do Alentejo,"Unidade Local de Saúde do Baixo Alentejo, EPE",62,35,97,2015,9,"-7.8721227,38.014123",4
2015-09-01,Região de Saúde do Centro,"Centro Hospitalar Tondela-Viseu, EPE",247,204,451,2015,9,"-8.0827433,40.516364",2
2015-10-01,Região de Saúde do Centro,"Unidade Local de Saúde de Castelo Branco, EPE",109,108,217,2015,10,"-7.4981271,39.8212263",2
2015-11-01,Região de Saúde do Alentejo,"Unidade Local de Saúde do Norte Alentejano, EPE",786,804,1590,2015,11,"-7.4263845,39.3003425",4
2015-11-01,Região de Saúde do Centro,"Centro Hospitalar do Baixo Vouga, EPE",486,539,1025,2015,11,"-8.6543716,40.6362453",2
2015-12-01,Região de Saúde Norte,"Centro Hospitalar Trás-os-Montes e Alto Douro, EPE",337,0,337,2015,12,"-7.7515252,41.3031784",1
2016-01-01,Região de Saúde do Alentejo,"Hospital Espírito Santo de Évora, EPE",91,14,105,2016,1,"-7.9032848,38.5684861",4
2016-01-01,Região de Saúde do Centro,"Centro Hospitalar do Baixo Vouga, EPE",39,71,110,2016,1,"-8.6543716,40.6362453",2
2016-01-01,Região de Saúde Norte,"Centro Hospitalar Universitário do Porto, EPE",32,0,32,2016,1,"-8.6172617,41.1472498",1
2016-02-01,Região de Saúde do Centro,"Centro Hospitalar Universitário Cova da Beira, EPE",40,33,73,2016,2,"-7.4922407,40.2804158",2
2016-03-01,Região de Saúde do Alentejo,"Hospital Espírito Santo de Évora, EPE",284,90,374,2016,3,"-7.9032848,38.5684861",4
2016-03-01,Região de Saúde do Alentejo,"Unidade Local de Saúde do Baixo Alentejo, EPE",14,9,23,2016,3,"-7.8721227,38.014123",4
2016-03-01,Região de Saúde Norte,"Centro Hospitalar Universitário do Porto, EPE",148,0,148,2016,3,"-8.6172617,41.1472498",1
2016-04-01,Região de Saúde do Centro,"Centro Hospitalar do Baixo Vouga, EPE",181,210,391,2016,4,"-8.6543716,40.6362453",2
2016-04-01,Região de Saúde do Centro,"Centro Hospitalar Tondela-Viseu, EPE",96,80,176,2016,4,"-8.0827433,40.516364",2
2016-04-01,Região de Saúde Norte,"Centro Hospitalar Universitário do Porto, EPE",202,0,202,2016,4,"-8.6172617,41.1472498",1
2016-05-01,Região de Saúde do Alentejo,"Unidade Local de Saúde do Norte Alentejano, EPE",200,252,452,2016,5,"-7.4263845,39.3003425",4
2016-05-01,Região de Saúde do Algarve,"Centro Hospitalar Universitário do Algarve,EPE",753,59,812,2016,5,"-7.9281554,37.0238973",5
2016-05-01,Região de Saúde do Centro,"Centro Hospitalar e Universitário de Coimbra, EPE",1181,620,1801,2016,5,"-8.4098211,40.2191523",2
2016-05-01,Região de Saúde do Centro,"Unidade Local de Saúde da Guarda, EPE",171,0,171,2016,5,"-7.2734793,40.5309916",2
2016-05-01,Região de Saúde Norte,"Centro Hospitalar Trás-os-Montes e Alto Douro, EPE",248,0,248,2016,5,"-7.7515252,41.3031784",1
2016-05-01,Região de Saúde Norte,"Unidade Local de Saúde de Matosinhos, EPE",801,0,801,2016,5,"-8.6745115,41.1794456",1
2016-06-01,Região de Saúde do Alentejo,"Hospital Espírito Santo de Évora, EPE",584,161,745,2016,6,"-7.9032848,38.5684861",4
2016-06-01,Região de Saúde do Centro,"Centro Hospitalar Universitário Cova da Beira, EPE",106,89,195,2016,6,"-7.4922407,40.2804158",2
2016-06-01,Região de Saúde do Centro,"Centro Hospitalar e Universitário de Coimbra, EPE",1377,716,2093,2016,6,"-8.4098211,40.2191523",2
2016-06-01,Região de Saúde LVT,"Instituto Português Oncologia de Lisboa, EPE",1,0,1,2016,6,"-9.1634516,38.7396768",3
2016-07-01,Região de Saúde do Alentejo,"Unidade Local de Saúde do Norte Alentejano, EPE",295,351,646,2016,7,"-7.4263845,39.3003425",4
2016-09-01,Região de Saúde do Centro,"Unidade Local de Saúde de Castelo Branco, EPE",114,80,194,2016,9,"-7.4981271,39.8212263",2
2016-09-01,Região de Saúde LVT,"Centro Hospitalar de Setúbal, EPE",25,0,25,2016,9,"-8.8818638,38.5283754",3
2016-09-01,Região de Saúde Norte,"Unidade Local de Saúde de Matosinhos, EPE",1383,0,1383,2016,9,"-8.6745115,41.1794456",1
2016-10-01,Região de Saúde Norte,"Unidade Local de Saúde de Matosinhos, EPE",1707,0,1707,2016,10,"-8.6745115,41.1794456",1
2016-11-01,Região de Saúde do Centro,"Centro Hospitalar e Universitário de Coimbra, EPE",2471,1236,3707,2016,11,"-8.4098211,40.2191523",2
2016-11-01,Região de Saúde do Centro,Centro Medicina de Reabilitação da Região Centro Rovisco Pais,24,1,25,2016,11,"-8.7707806,40.297919",2
2016-12-01,Região de Saúde do Centro,"Centro Hospitalar Universitário Cova da Beira, EPE",182,145,327,2016,12,"-7.4922407,40.2804158",2
2016-12-01,Região de Saúde do Centro,"Unidade Local de Saúde da Guarda, EPE",375,0,375,2016,12,"-7.2734793,40.5309916",2
2017-01-01,Região de Saúde do Algarve,"Centro Hospitalar Universitário do Algarve,EPE",47,2,49,2017,1,"-7.9281554,37.0238973",5
2017-01-01,Região de Saúde do Centro,"Centro Hospitalar e Universitário de Coimbra, EPE",179,91,270,2017,1,"-8.4098211,40.2191523",2
2017-01-01,Região de Saúde do Centro,Centro Medicina de Reabilitação da Região Centro Rovisco Pais,3,1,4,2017,1,"-8.7707806,40.297919",2
2017-01-01,Região de Saúde LVT,"Centro Hospitalar Universitário Lisboa Central, EPE",3,0,3,2017,1,"-9.1371248,38.7166948",3
2017-02-01,Região de Saúde do Centro,"Centro Hospitalar do Baixo Vouga, EPE",81,113,194,2017,2,"-8.6543716,40.6362453",2
2017-02-01,Região de Saúde do Centro,"Centro Hospitalar e Universitário de Coimbra, EPE",411,206,617,2017,2,"-8.4098211,40.2191523",2
2017-02-01,Região de Saúde do Centro,"Unidade Local de Saúde da Guarda, EPE",51,0,51,2017,2,"-7.2734793,40.5309916",2
2017-03-01,Região de Saúde do Alentejo,"Unidade Local de Saúde do Litoral Alentejano, EPE",5,3,8,2017,3,"-8.6956768,38.0162314",4
2017-03-01,Região de Saúde LVT,"Hospital Garcia de Orta, EPE",47,0,47,2017,3,"-9.1822554,38.6658713",3
2017-03-01,Região de Saúde Norte,"Unidade Local de Saúde de Matosinhos, EPE",544,3521,4065,2017,3,"-8.6745115,41.1794456",1
2017-04-01,Região de Saúde do Centro,"Centro Hospitalar Universitário Cova da Beira, EPE",62,38,100,2017,4,"-7.4922407,40.2804158",2
2017-04-01,Região de Saúde Norte,"Centro Hospitalar Trás-os-Montes e Alto Douro, EPE",146,1,147,2017,4,"-7.7515252,41.3031784",1
2017-05-01,Região de Saúde do Centro,"Centro Hospitalar Universitário Cova da Beira, EPE",81,44,125,2017,5,"-7.4922407,40.2804158",2
2017-06-01,Região de Saúde do Centro,"Unidade Local de Saúde da Guarda, EPE",211,0,211,2017,6,"-7.2734793,40.5309916",2
2017-06-01,Região de Saúde LVT,"Hospital Garcia de Orta, EPE",92,0,92,2017,6,"-9.1822554,38.6658713",3
2017-06-01,Região de Saúde Norte,"Centro Hospitalar Trás-os-Montes e Alto Douro, EPE",238,1,239,2017,6,"-7.7515252,41.3031784",1
2017-07-01,Região de Saúde do Centro,"Centro Hospitalar de Leiria, EPE",234,160,394,2017,7,"-8.7982706,39.7414812",2
2017-07-01,Região de Saúde do Centro,"Centro Hospitalar do Baixo Vouga, EPE",325,331,656,2017,7,"-8.6543716,40.6362453",2
2017-07-01,Região de Saúde do Centro,"Centro Hospitalar e Universitário de Coimbra, EPE",1436,699,2135,2017,7,"-8.4098211,40.2191523",2
2017-08-01,Região de Saúde do Alentejo,"Unidade Local de Saúde do Litoral Alentejano, EPE",19,20,39,2017,8,"-8.6956768,38.0162314",4
2017-08-01,Região de Saúde do Centro,"Centro Hospitalar Universitário Cova da Beira, EPE",151,70,221,2017,8,"-7.4922407,40.2804158",2
2017-08-01,Região de Saúde do Centro,"Centro Hospitalar e Universitário de Coimbra, EPE",1585,733,2318,2017,8,"-8.4098211,40.2191523",2
2017-08-01,Região de Saúde do Centro,"Centro Hospitalar Tondela-Viseu, EPE",132,80,212,2017,8,"-8.0827433,40.516364",2
2017-08-01,Região de Saúde do Centro,"Unidade Local de Saúde da Guarda, EPE",302,0,302,2017,8,"-7.2734793,40.5309916",2
2017-08-01,Região de Saúde LVT,"Centro Hospitalar Universitário Lisboa Central, EPE",13,17,30,2017,8,"-9.1371248,38.7166948",3
2017-08-01,Região de Saúde LVT,"Hospital Garcia de Orta, EPE",149,0,149,2017,8,"-9.1822554,38.6658713",3
2017-09-01,Região de Saúde do Alentejo,"Unidade Local de Saúde do Litoral Alentejano, EPE",19,20,39,2017,9,"-8.6956768,38.0162314",4
2017-09-01,Região de Saúde do Centro,"Centro Hospitalar Universitário Cova da Beira, EPE",163,74,237,2017,9,"-7.4922407,40.2804158",2
2017-09-01,Região de Saúde do Centro,"Centro Hospitalar Tondela-Viseu, EPE",148,89,237,2017,9,"-8.0827433,40.516364",2
2017-09-01,Região de Saúde LVT,"Hospital Garcia de Orta, EPE",185,0,185,2017,9,"-9.1822554,38.6658713",3
2017-10-01,Região de Saúde do Centro,Centro Medicina de Reabilitação da Região Centro Rovisco Pais,27,1,28,2017,10,"-8.7707806,40.297919",2
2017-10-01,Região de Saúde LVT,"Centro Hospitalar Universitário Lisboa Central, EPE",19,22,41,2017,10,"-9.1371248,38.7166948",3
2017-10-01,Região de Saúde Norte,"Unidade Local de Saúde de Matosinhos, EPE",2124,11098,13222,2017,10,"-8.6745115,41.1794456",1
2017-11-01,Região de Saúde do Centro,Centro Medicina de Reabilitação da Região Centro Rovisco Pais,28,1,29,2017,11,"-8.7707806,40.297919",2
2017-11-01,Região de Saúde do Centro,"Unidade Local de Saúde de Castelo Branco, EPE",296,127,423,2017,11,"-7.4981271,39.8212263",2
2017-11-01,Região de Saúde LVT,"Centro Hospitalar Universitário Lisboa Central, EPE",19,24,43,2017,11,"-9.1371248,38.7166948",3
2017-12-01,Região de Saúde do Alentejo,"Unidade Local de Saúde do Litoral Alentejano, EPE",32,20,52,2017,12,"-8.6956768,38.0162314",4
2017-12-01,Região de Saúde do Algarve,"Centro Hospitalar Universitário do Algarve,EPE",613,6,619,2017,12,"-7.9281554,37.0238973",5
2017-12-01,Região de Saúde do Centro,"Centro Hospitalar Universitário Cova da Beira, EPE",213,99,312,2017,12,"-7.4922407,40.2804158",2
2017-12-01,Região de Saúde do Centro,"Unidade Local de Saúde de Castelo Branco, EPE",311,134,445,2017,12,"-7.4981271,39.8212263",2
2017-12-01,Região de Saúde Norte,"Centro Hospitalar Universitário do Porto, EPE",1709,0,1709,2017,12,"-8.6172617,41.1472498",1
2018-01-01,Região de Saúde do Alentejo,"Hospital Espírito Santo de Évora, EPE",84,42,126,2018,1,"-7.9032848,38.5684861",4
2018-01-01,Região de Saúde do Centro,"Centro Hospitalar do Baixo Vouga, EPE",21,43,64,2018,1,"-8.6543716,40.6362453",2
2018-01-01,Região de Saúde LVT,"Centro Hospitalar de Lisboa Ocidental, EPE",11,0,11,2018,1,"-9.216985,38.708454",3
2018-01-01,Região de Saúde Norte,"Instituto Português Oncologia do Porto, EPE",12,2,14,2018,1,"-8.6062881,41.1785642",1
2018-02-01,Região de Saúde LVT,"Hospital Garcia de Orta, EPE",105,0,105,2018,2,"-9.1822554,38.6658713",3
2018-03-01,Região de Saúde do Centro,"Centro Hospitalar e Universitário de Coimbra, EPE",451,159,610,2018,3,"-8.4098211,40.2191523",2
2018-03-01,Região de Saúde LVT,"Centro Hospitalar Universitário Lisboa Central, EPE",6,12,18,2018,3,"-9.1371248,38.7166948",3
2018-04-01,Região de Saúde do Alentejo,"Hospital Espírito Santo de Évora, EPE",336,146,482,2018,4,"-7.9032848,38.5684861",4
2018-04-01,Região de Saúde do Centro,"Centro Hospitalar Tondela-Viseu, EPE",25,17,42,2018,4,"-8.0827433,40.516364",2
2018-04-01,Região de Saúde do Centro,"Unidade Local de Saúde de Castelo Branco, EPE",118,45,163,2018,4,"-7.4981271,39.8212263",2
2018-04-01,Região de Saúde LVT,"Centro Hospitalar Universitário de Lisboa Norte, EPE",130,0,130,2018,4,"-9.1616116,38.7500861",3
2018-04-01,Região de Saúde Norte,"Instituto Português Oncologia do Porto, EPE",41,25,66,2018,4,"-8.6062881,41.1785642",1
2018-05-01,Região de Saúde do Centro,"Centro Hospitalar Universitário Cova da Beira, EPE",181,72,253,2018,5,"-7.4922407,40.2804158",2
2018-05-01,Região de Saúde do Centro,"Centro Hospitalar de Leiria, EPE",166,109,275,2018,5,"-8.7982706,39.7414812",2
2018-05-01,Região de Saúde do Centro,"Unidade Local de Saúde da Guarda, EPE",277,0,277,2018,5,"-7.2734793,40.5309916",2
2018-05-01,Região de Saúde LVT,"Centro Hospitalar de Lisboa Ocidental, EPE",50,0,50,2018,5,"-9.216985,38.708454",3
2018-05-01,Região de Saúde Norte,"Unidade Local de Saúde de Matosinhos, EPE",0,5291,5291,2018,5,"-8.6745115,41.1794456",1
2018-06-01,Região de Saúde do Alentejo,"Hospital Espírito Santo de Évora, EPE",484,201,685,2018,6,"-7.9032848,38.5684861",4
2018-06-01,Região de Saúde do Centro,"Centro Hospitalar Universitário Cova da Beira, EPE",210,83,293,2018,6,"-7.4922407,40.2804158",2
2018-06-01,Região de Saúde do Centro,"Centro Hospitalar do Baixo Vouga, EPE",184,217,401,2018,6,"-8.6543716,40.6362453",2
2018-06-01,Região de Saúde do Centro,"Unidade Local de Saúde da Guarda, EPE",336,0,336,2018,6,"-7.2734793,40.5309916",2
2018-06-01,Região de Saúde Norte,"Centro Hospitalar Entre Douro e Vouga, EPE",4,0,4,2018,6,"-8.5458794,40.9293884",1
2018-06-01,Região de Saúde Norte,"Unidade Local de Saúde de Matosinhos, EPE",0,6439,6439,2018,6,"-8.6745115,41.1794456",1
2018-07-01,Região de Saúde do Alentejo,"Unidade Local de Saúde do Litoral Alentejano, EPE",12,19,31,2018,7,"-8.6956768,38.0162314",4
2018-07-01,Região de Saúde do Algarve,"Centro Hospitalar Universitário do Algarve,EPE",9,6,15,2018,7,"-7.9281554,37.0238973",5
2018-07-01,Região de Saúde do Centro,"Unidade Local de Saúde da Guarda, EPE",403,0,403,2018,7,"-7.2734793,40.5309916",2
2018-07-01,Região de Saúde LVT,"Centro Hospitalar de Lisboa Ocidental, EPE",70,0,70,2018,7,"-9.216985,38.708454",3
2018-08-01,Região de Saúde do Alentejo,"Unidade Local de Saúde do Litoral Alentejano, EPE",16,23,39,2018,8,"-8.6956768,38.0162314",4
2018-08-01,Região de Saúde do Centro,"Centro Hospitalar e Universitário de Coimbra, EPE",1384,658,2042,2018,8,"-8.4098211,40.2191523",2
2018-08-01,Região de Saúde LVT,"Centro Hospitalar Universitário de Lisboa Norte, EPE",327,0,327,2018,8,"-9.1616116,38.7500861",3
2018-08-01,Região de Saúde Norte,"Instituto Português Oncologia do Porto, EPE",76,55,131,2018,8,"-8.6062881,41.1785642",1
2018-09-01,Região de Saúde do Algarve,"Centro Hospitalar Universitário do Algarve,EPE",14,7,21,2018,9,"-7.9281554,37.0238973",5
2018-09-01,Região de Saúde do Centro,"Centro Hospitalar do Baixo Vouga, EPE",306,291,597,2018,9,"-8.6543716,40.6362453",2
2018-09-01,Região de Saúde do Centro,"Centro Hospitalar Tondela-Viseu, EPE",122,111,233,2018,9,"-8.0827433,40.516364",2
2018-09-01,Região de Saúde LVT,"Centro Hospitalar Universitário Lisboa Central, EPE",31,25,56,2018,9,"-9.1371248,38.7166948",3
2018-10-01,Região de Saúde do Alentejo,"Hospital Espírito Santo de Évora, EPE",721,270,991,2018,10,"-7.9032848,38.5684861",4
2018-10-01,Região de Saúde do Centro,"Centro Hospitalar Universitário Cova da Beira, EPE",388,130,518,2018,10,"-7.4922407,40.2804158",2
2018-10-01,Região de Saúde do Centro,"Unidade Local de Saúde da Guarda, EPE",575,0,575,2018,10,"-7.2734793,40.5309916",2
2018-10-01,Região de Saúde do Centro,"Unidade Local de Saúde de Castelo Branco, EPE",188,126,314,2018,10,"-7.4981271,39.8212263",2
2018-10-01,Região de Saúde LVT,"Centro Hospitalar de Lisboa Ocidental, EPE",110,0,110,2018,10,"-9.216985,38.708454",3
2018-10-01,Região de Saúde LVT,"Centro Hospitalar Universitário de Lisboa Norte, EPE",537,1,538,2018,10,"-9.1616116,38.7500861",3
2018-10-01,Região de Saúde Norte,"Centro Hospitalar Trás-os-Montes e Alto Douro, EPE",370,0,370,2018,10,"-7.7515252,41.3031784",1
2018-10-01,Região de Saúde Norte,"Instituto Português Oncologia do Porto, EPE",95,60,155,2018,10,"-8.6062881,41.1785642",1
2018-11-01,Região de Saúde do Centro,"Centro Hospitalar do Baixo Vouga, EPE",437,375,812,2018,11,"-8.6543716,40.6362453",2
2018-11-01,Região de Saúde do Centro,"Unidade Local de Saúde da Guarda, EPE",641,0,641,2018,11,"-7.2734793,40.5309916",2
2018-11-01,Região de Saúde do Centro,"Unidade Local de Saúde de Castelo Branco, EPE",214,141,355,2018,11,"-7.4981271,39.8212263",2
2018-11-01,Região de Saúde Norte,"Centro Hospitalar Universitário do Porto, EPE",2289,0,2289,2018,11,"-8.6172617,41.1472498",1
2018-11-01,Região de Saúde Norte,"Centro Hospitalar Entre Douro e Vouga, EPE",4,0,4,2018,11,"-8.5458794,40.9293884",1
2018-11-01,Região de Saúde Norte,"Hospital Santa Maria Maior, EPE",3,0,3,2018,11,"-8.6171561,41.5324234",1
2018-12-01,Região de Saúde do Centro,"Centro Hospitalar Universitário Cova da Beira, EPE",468,142,610,2018,12,"-7.4922407,40.2804158",2
2018-12-01,Região de Saúde do Centro,"Centro Hospitalar do Baixo Vouga, EPE",476,395,871,2018,12,"-8.6543716,40.6362453",2
2018-12-01,Região de Saúde do Centro,"Centro Hospitalar Tondela-Viseu, EPE",237,172,409,2018,12,"-8.0827433,40.516364",2
2018-12-01,Região de Saúde do Centro,"Unidade Local de Saúde de Castelo Branco, EPE",231,155,386,2018,12,"-7.4981271,39.8212263",2
2018-12-01,Região de Saúde LVT,"Centro Hospitalar de Lisboa Ocidental, EPE",151,0,151,2018,12,"-9.216985,38.708454",3
2018-12-01,Região de Saúde LVT,"Hospital Garcia de Orta, EPE",571,0,571,2018,12,"-9.1822554,38.6658713",3
2018-12-01,Região de Saúde Norte,"Centro Hospitalar Universitário do Porto, EPE",2478,0,2478,2018,12,"-8.6172617,41.1472498",1
2018-12-01,Região de Saúde Norte,"Hospital Santa Maria Maior, EPE",4,0,4,2018,12,"-8.6171561,41.5324234",1
2019-01-01,Região de Saúde do Centro,Hospital Arcebispo João Crisóstomo,0,0,0,2019,1,"-8.5933462,40.3470015",2
2019-01-01,Região de Saúde do Centro,"Unidade Local de Saúde de Castelo Branco, EPE",34,9,43,2019,1,"-7.4981271,39.8212263",2
2019-01-01,Região de Saúde Norte,"Centro Hospitalar Universitário do Porto, EPE",266,0,266,2019,1,"-8.6172617,41.1472498",1
2019-01-01,Região de Saúde Norte,"Centro Hospitalar Trás-os-Montes e Alto Douro, EPE",103,0,103,2019,1,"-7.7515252,41.3031784",1
2019-02-01,Região de Saúde do Alentejo,"Unidade Local de Saúde do Baixo Alentejo, EPE",10,16,26,2019,2,"-7.8721227,38.014123",4
2019-02-01,Região de Saúde Norte,"Centro Hospitalar Universitário do Porto, EPE",455,0,455,2019,2,"-8.6172617,41.1472498",1
2019-02-01,Região de Saúde Norte,"Hospital Santa Maria Maior, EPE",0,3,3,2019,2,"-8.6171561,41.5324234",1
2019-03-01,Região de Saúde do Alentejo,"Unidade Local de Saúde do Litoral Alentejano, EPE",7,9,16,2019,3,"-8.6956768,38.0162314",4
2019-03-01,Região de Saúde do Centro,"Centro Hospitalar de Leiria, EPE",100,72,172,2019,3,"-8.7982706,39.7414812",2
2019-03-01,Região de Saúde LVT,"Centro Hospitalar de Lisboa Ocidental, EPE",50,0,50,2019,3,"-9.216985,38.708454",3
2019-03-01,Região de Saúde LVT,"Centro Hospitalar Universitário de Lisboa Norte, EPE",517,7,524,2019,3,"-9.1616116,38.7500861",3
2019-03-01,Região de Saúde Norte,"Instituto Português Oncologia do Porto, EPE",17,16,33,2019,3,"-8.6062881,41.1785642",1
2019-03-01,Região de Saúde Norte,"Unidade Local de Saúde de Matosinhos, EPE",0,2938,2938,2019,3,"-8.6745115,41.1794456",1
2019-04-01,Região de Saúde do Alentejo,"Unidade Local de Saúde do Baixo Alentejo, EPE",18,26,44,2019,4,"-7.8721227,38.014123",4
2019-04-01,Região de Saúde do Alentejo,"Unidade Local de Saúde do Norte Alentejano, EPE",208,77,285,2019,4,"-7.4263845,39.3003425",4
2019-04-01,Região de Saúde do Centro,"Centro Hospitalar e Universitário de Coimbra, EPE",925,287,1212,2019,4,"-8.4098211,40.2191523",2
2019-04-01,Região de Saúde do Centro,Hospital Arcebispo João Crisóstomo,30,0,30,2019,4,"-8.5933462,40.3470015",2
2019-04-01,Região de Saúde Norte,"Instituto Português Oncologia do Porto, EPE",16,18,34,2019,4,"-8.6062881,41.1785642",1
2019-05-01,Região de Saúde do Alentejo,"Hospital Espírito Santo de Évora, EPE",643,304,947,2019,5,"-7.9032848,38.5684861",4
2019-05-01,Região de Saúde do Alentejo,"Unidade Local de Saúde do Litoral Alentejano, EPE",9,10,19,2019,5,"-8.6956768,38.0162314",4
2019-05-01,Região de Saúde do Centro,"Centro Hospitalar Tondela-Viseu, EPE",100,45,145,2019,5,"-8.0827433,40.516364",2
2019-05-01,Região de Saúde do Centro,Hospital Arcebispo João Crisóstomo,42,0,42,2019,5,"-8.5933462,40.3470015",2
2019-05-01,Região de Saúde LVT,"Centro Hospitalar Universitário de Lisboa Norte, EPE",1137,7,1144,2019,5,"-9.1616116,38.7500861",3
2019-05-01,Região de Saúde Norte,"Centro Hospitalar Trás-os-Montes e Alto Douro, EPE",567,0,567,2019,5,"-7.7515252,41.3031784",1
2019-06-01,Região de Saúde do Alentejo,"Unidade Local de Saúde do Norte Alentejano, EPE",316,115,431,2019,6,"-7.4263845,39.3003425",4
2019-06-01,Região de Saúde do Centro,"Centro Hospitalar Universitário Cova da Beira, EPE",259,49,308,2019,6,"-7.4922407,40.2804158",2
2019-06-01,Região de Saúde do Centro,"Centro Hospitalar de Leiria, EPE",189,137,326,2019,6,"-8.7982706,39.7414812",2
2019-06-01,Região de Saúde do Centro,"Centro Hospitalar do Baixo Vouga, EPE",342,243,585,2019,6,"-8.6543716,40.6362453",2
2019-06-01,Região de Saúde do Centro,Hospital Arcebispo João Crisóstomo,54,0,54,2019,6,"-8.5933462,40.3470015",2
2019-06-01,Região de Saúde LVT,"Centro Hospitalar de Setúbal, EPE",0,0,0,2019,6,"-8.8818638,38.5283754",3
2019-07-01,Região de Saúde do Alentejo,"Hospital Espírito Santo de Évora, EPE",828,402,1230,2019,7,"-7.9032848,38.5684861",4
2019-07-01,Região de Saúde do Centro,"Centro Hospitalar Tondela-Viseu, EPE",121,57,178,2019,7,"-8.0827433,40.516364",2
2019-07-01,Região de Saúde do Centro,"Unidade Local de Saúde de Castelo Branco, EPE",183,91,274,2019,7,"-7.4981271,39.8212263",2
2019-08-01,Região de Saúde do Alentejo,"Unidade Local de Saúde do Litoral Alentejano, EPE",13,18,31,2019,8,"-8.6956768,38.0162314",4
2019-08-01,Região de Saúde do Centro,"Centro Hospitalar do Baixo Vouga, EPE",443,284,727,2019,8,"-8.6543716,40.6362453",2
2019-08-01,Região de Saúde LVT,"Centro Hospitalar Médio Tejo, EPE",8,5,13,2019,8,"-8.5404429,39.478072",3
2019-08-01,Região de Saúde Norte,"Instituto Português Oncologia do Porto, EPE",49,38,87,2019,8,"-8.6062881,41.1785642",1
2019-08-01,Região de Saúde Norte,"Unidade Local de Saúde de Matosinhos, EPE",0,7890,7890,2019,8,"-8.6745115,41.1794456",1
2019-09-01,Região de Saúde do Alentejo,"Unidade Local de Saúde do Baixo Alentejo, EPE",29,37,66,2019,9,"-7.8721227,38.014123",4
2019-09-01,Região de Saúde do Algarve,"Centro Hospitalar Universitário do Algarve,EPE",0,0,0,2019,9,"-7.9281554,37.0238973",5
2019-09-01,Região de Saúde do Centro,"Centro Hospitalar do Baixo Vouga, EPE",510,323,833,2019,9,"-8.6543716,40.6362453",2
2019-09-01,Região de Saúde Norte,"Centro Hospitalar Universitário do Porto, EPE",1726,0,1726,2019,9,"-8.6172617,41.1472498",1
2019-10-01,Região de Saúde do Centro,"Centro Hospitalar Universitário Cova da Beira, EPE",372,67,439,2019,10,"-7.4922407,40.2804158",2
2019-10-01,Região de Saúde do Centro,"Centro Hospitalar Tondela-Viseu, EPE",230,68,298,2019,10,"-8.0827433,40.516364",2
2019-10-01,Região de Saúde Norte,"Centro Hospitalar Trás-os-Montes e Alto Douro, EPE",901,0,901,2019,10,"-7.7515252,41.3031784",1
2019-10-01,Região de Saúde Norte,"Instituto Português Oncologia do Porto, EPE",60,48,108,2019,10,"-8.6062881,41.1785642",1
2019-11-01,Região de Saúde do Alentejo,"Hospital Espírito Santo de Évora, EPE",1216,632,1848,2019,11,"-7.9032848,38.5684861",4
2019-11-01,Região de Saúde do Alentejo,"Unidade Local de Saúde do Baixo Alentejo, EPE",37,39,76,2019,11,"-7.8721227,38.014123",4
2019-11-01,Região de Saúde do Centro,"Centro Hospitalar Universitário Cova da Beira, EPE",405,68,473,2019,11,"-7.4922407,40.2804158",2
2019-11-01,Região de Saúde LVT,"Centro Hospitalar Médio Tejo, EPE",13,11,24,2019,11,"-8.5404429,39.478072",3
2019-12-01,Região de Saúde do Alentejo,"Hospital Espírito Santo de Évora, EPE",1280,663,1943,2019,12,"-7.9032848,38.5684861",4
2019-12-01,Região de Saúde LVT,"Centro Hospitalar Médio Tejo, EPE",13,13,26,2019,12,"-8.5404429,39.478072",3
2019-12-01,Região de Saúde Norte,"Unidade Local de Saúde de Matosinhos, EPE",0,11431,11431,2019,12,"-8.6745115,41.1794456",1
2020-01-01,Região de Saúde do Centro,"Centro Hospitalar de Leiria, EPE",0,0,0,2020,1,"-8.7982706,39.7414812",2
2020-01-01,Região de Saúde do Centro,"Centro Hospitalar e Universitário de Coimbra, EPE",190,71,261,2020,1,"-8.4098211,40.2191523",2
2020-01-01,Região de Saúde do Centro,Hospital Arcebispo João Crisóstomo,32,0,32,2020,1,"-8.5933462,40.3470015",2
2020-01-01,Região de Saúde do Centro,"Unidade Local de Saúde de Castelo Branco, EPE",32,17,49,2020,1,"-7.4981271,39.8212263",2
2020-01-01,Região de Saúde LVT,"Centro Hospitalar de Lisboa Ocidental, EPE",29,0,29,2020,1,"-9.216985,38.708454",3
2020-01-01,Região de Saúde LVT,"Centro Hospitalar de Setúbal, EPE",0,0,0,2020,1,"-8.8818638,38.5283754",3
2020-01-01,Região de Saúde Norte,"Centro Hospitalar Universitário de São João, EPE",0,0,0,2020,1,"-8.6010558,41.1831056",1
2020-02-01,Região de Saúde do Centro,"Centro Hospitalar Tondela-Viseu, EPE",56,4,60,2020,2,"-8.0827433,40.516364",2
2020-02-01,Região de Saúde do Centro,"Unidade Local de Saúde de Castelo Branco, EPE",53,26,79,2020,2,"-7.4981271,39.8212263",2
2020-02-01,Região de Saúde LVT,"Centro Hospitalar Universitário de Lisboa Norte, EPE",592,4,596,2020,2,"-9.1616116,38.7500861",3
2020-02-01,Região de Saúde Norte,"Centro Hospitalar Universitário de São João, EPE",0,0,0,2020,2,"-8.6010558,41.1831056",1
2020-02-01,Região de Saúde Norte,"Unidade Local de Saúde de Matosinhos, EPE",0,1921,1921,2020,2,"-8.6745115,41.1794456",1
2020-03-01,Região de Saúde do Alentejo,"Unidade Local de Saúde do Norte Alentejano, EPE",118,56,174,2020,3,"-7.4263845,39.3003425",4
2020-03-01,Região de Saúde do Centro,Hospital Arcebispo João Crisóstomo,78,0,78,2020,3,"-8.5933462,40.3470015",2
2020-03-01,Região de Saúde Norte,"Centro Hospitalar Universitário de São João, EPE",0,0,0,2020,3,"-8.6010558,41.1831056",1
2020-03-01,Região de Saúde Norte,"Centro Hospitalar Entre Douro e Vouga, EPE",0,0,0,2020,3,"-8.5458794,40.9293884",1
2020-04-01,Região de Saúde do Alentejo,"Unidade Local de Saúde do Baixo Alentejo, EPE",332,1844,2176,2020,4,"-7.8721227,38.014123",4
2020-04-01,Região de Saúde do Centro,"Centro Hospitalar Universitário Cova da Beira, EPE",98,24,122,2020,4,"-7.4922407,40.2804158",2
2020-04-01,Região de Saúde do Centro,"Centro Hospitalar de Leiria, EPE",79,93,172,2020,4,"-8.7982706,39.7414812",2
2020-04-01,Região de Saúde do Centro,"Centro Hospitalar do Baixo Vouga, EPE",139,114,253,2020,4,"-8.6543716,40.6362453",2
2020-04-01,Região de Saúde do Centro,"Unidade Local de Saúde de Castelo Branco, EPE",76,39,115,2020,4,"-7.4981271,39.8212263",2
2020-04-01,Região de Saúde LVT,"Hospital Garcia de Orta, EPE",0,0,0,2020,4,"-9.1822554,38.6658713",3
2020-04-01,Região de Saúde Norte,"Hospital de Braga, EPE",2343,0,2343,2020,4,"-8.398982,41.56785",1
2020-05-01,Região de Saúde LVT,"Centro Hospitalar de Setúbal, EPE",0,0,0,2020,5,"-8.8818638,38.5283754",3
2020-06-01,Região de Saúde do Centro,"Centro Hospitalar do Baixo Vouga, EPE",157,151,308,2020,6,"-8.6543716,40.6362453",2
2020-06-01,Região de Saúde do Centro,"Centro Hospitalar Tondela-Viseu, EPE",96,11,107,2020,6,"-8.0827433,40.516364",2
2020-06-01,Região de Saúde LVT,Centro Hospitalar Psiquiátrico de Lisboa,101,4628,4729,2020,6,"-9.1460705,38.7569771",3
2020-06-01,Região de Saúde Norte,"Centro Hospitalar Póvoa de Varzim/Vila do Conde, EPE",24,55,79,2020,6,"-8.7589945,41.3828711",1
2020-06-01,Região de Saúde Norte,"Instituto Português Oncologia do Porto, EPE",58,33,91,2020,6,"-8.6062881,41.1785642",1
2020-07-01,Região de Saúde do Centro,"Centro Hospitalar de Leiria, EPE",192,223,415,2020,7,"-8.7982706,39.7414812",2
2020-07-01,Região de Saúde do Centro,Hospital Arcebispo João Crisóstomo,86,0,86,2020,7,"-8.5933462,40.3470015",2
2020-07-01,Região de Saúde LVT,"Centro Hospitalar de Setúbal, EPE",0,0,0,2020,7,"-8.8818638,38.5283754",3
2020-07-01,Região de Saúde LVT,Centro Hospitalar Psiquiátrico de Lisboa,117,5600,5717,2020,7,"-9.1460705,38.7569771",3
2020-07-01,Região de Saúde LVT,"Hospital Garcia de Orta, EPE",0,0,0,2020,7,"-9.1822554,38.6658713",3
2020-08-01,Região de Saúde do Alentejo,"Unidade Local de Saúde do Baixo Alentejo, EPE",558,3127,3685,2020,8,"-7.8721227,38.014123",4
2020-08-01,Região de Saúde do Alentejo,"Unidade Local de Saúde do Litoral Alentejano, EPE",0,0,0,2020,8,"-8.6956768,38.0162314",4
2020-08-01,Região de Saúde do Centro,"Centro Hospitalar de Leiria, EPE",228,246,474,2020,8,"-8.7982706,39.7414812",2
2020-08-01,Região de Saúde do Centro,"Centro Hospitalar e Universitário de Coimbra, EPE",1400,425,1825,2020,8,"-8.4098211,40.2191523",2
2020-08-01,Região de Saúde Norte,"Centro Hospitalar Universitário do Porto, EPE",1245,0,1245,2020,8,"-8.6172617,41.1472498",1
2020-08-01,Região de Saúde Norte,"Centro Hospitalar Vila Nova de Gaia/Espinho, EPE",717,0,717,2020,8,"-8.5972617,41.1094138",1
2020-09-01,Região de Saúde do Alentejo,"Hospital Espírito Santo de Évora, EPE",1139,224,1363,2020,9,"-7.9032848,38.5684861",4
2020-09-01,Região de Saúde do Algarve,"Centro Hospitalar Universitário do Algarve,EPE",0,0,0,2020,9,"-7.9281554,37.0238973",5
2020-09-01,Região de Saúde do Centro,"Centro Hospitalar de Leiria, EPE",250,266,516,2020,9,"-8.7982706,39.7414812",2
2020-09-01,Região de Saúde do Centro,"Centro Hospitalar do Baixo Vouga, EPE",207,286,493,2020,9,"-8.6543716,40.6362453",2
2020-09-01,Região de Saúde do Centro,"Centro Hospitalar Tondela-Viseu, EPE",182,34,216,2020,9,"-8.0827433,40.516364",2
2020-09-01,Região de Saúde do Centro,"Unidade Local de Saúde de Castelo Branco, EPE",114,66,180,2020,9,"-7.4981271,39.8212263",2
2020-09-01,Região de Saúde LVT,"Centro Hospitalar Universitário de Lisboa Norte, EPE",1749,56,1805,2020,9,"-9.1616116,38.7500861",3
2020-10-01,Região de Saúde do Alentejo,"Unidade Local de Saúde do Baixo Alentejo, EPE",617,3481,4098,2020,10,"-7.8721227,38.014123",4
2020-10-01,Região de Saúde LVT,"Centro Hospitalar de Lisboa Ocidental, EPE",162,0,162,2020,10,"-9.216985,38.708454",3
2020-10-01,Região de Saúde LVT,"Hospital Garcia de Orta, EPE",0,0,0,2020,10,"-9.1822554,38.6658713",3
2020-10-01,Região de Saúde Norte,"Centro Hospitalar Póvoa de Varzim/Vila do Conde, EPE",234,203,437,2020,10,"-8.7589945,41.3828711",1
2020-10-01,Região de Saúde Norte,"Instituto Português Oncologia do Porto, EPE",83,57,140,2020,10,"-8.6062881,41.1785642",1
2020-11-01,Região de Saúde do Alentejo,"Unidade Local de Saúde do Baixo Alentejo, EPE",635,3561,4196,2020,11,"-7.8721227,38.014123",4
2020-11-01,Região de Saúde do Centro,"Centro Hospitalar de Leiria, EPE",285,353,638,2020,11,"-8.7982706,39.7414812",2
2020-11-01,Região de Saúde LVT,"Centro Hospitalar de Setúbal, EPE",0,0,0,2020,11,"-8.8818638,38.5283754",3
2020-11-01,Região de Saúde LVT,"Centro Hospitalar Médio Tejo, EPE",3,18,21,2020,11,"-8.5404429,39.478072",3
2020-11-01,Região de Saúde LVT,Centro Hospitalar Psiquiátrico de Lisboa,283,8639,8922,2020,11,"-9.1460705,38.7569771",3
2020-11-01,Região de Saúde Norte,"Hospital de Braga, EPE",4434,0,4434,2020,11,"-8.398982,41.56785",1
2020-11-01,Região de Saúde Norte,"Unidade Local de Saúde de Matosinhos, EPE",0,8355,8355,2020,11,"-8.6745115,41.1794456",1
2020-12-01,Região de Saúde do Centro,"Centro Hospitalar de Leiria, EPE",308,370,678,2020,12,"-8.7982706,39.7414812",2
2020-12-01,Região de Saúde do Centro,Hospital Arcebispo João Crisóstomo,122,0,122,2020,12,"-8.5933462,40.3470015",2
2020-12-01,Região de Saúde LVT,"Hospital Garcia de Orta, EPE",14,3,17,2020,12,"-9.1822554,38.6658713",3
2020-12-01,Região de Saúde Norte,"Centro Hospitalar Póvoa de Varzim/Vila do Conde, EPE",348,271,619,2020,12,"-8.7589945,41.3828711",1
2020-12-01,Região de Saúde Norte,"Centro Hospitalar Trás-os-Montes e Alto Douro, EPE",646,2,648,2020,12,"-7.7515252,41.3031784",1
2020-12-01,Região de Saúde Norte,"Instituto Português Oncologia do Porto, EPE",89,67,156,2020,12,"-8.6062881,41.1785642",1
2021-01-01,Região de Saúde do Alentejo,"Unidade Local de Saúde do Norte Alentejano, EPE",11,10,21,2021,1,"-7.4263845,39.3003425",4
2021-01-01,Região de Saúde do Algarve,"Centro Hospitalar Universitário do Algarve,EPE",0,0,0,2021,1,"-7.9281554,37.0238973",5
2021-01-01,Região de Saúde do Centro,"Centro Hospitalar do Baixo Vouga, EPE",34,33,67,2021,1,"-8.6543716,40.6362453",2
2021-01-01,Região de Saúde LVT,"Centro Hospitalar do Oeste, EPE, EPE",1244,3002,4246,2021,1,"-9.1258493,39.4054629",3
2021-01-01,Região de Saúde LVT,"Hospital Distrital de Santarém, EPE",0,11,11,2021,1,"-8.6937515,39.2410946",3
2021-01-01,Região de Saúde Norte,"Centro Hospitalar Póvoa de Varzim/Vila do Conde, EPE",53,30,83,2021,1,"-8.7589945,41.3828711",1
2021-01-01,Região de Saúde Norte,"Hospital da Senhora da Oliveira, Guimarães, EPE",53,0,53,2021,1,"-8.3086907,41.4387173",1
2021-01-01,Região de Saúde Norte,"Hospital de Braga, EPE",28,0,28,2021,1,"-8.398982,41.56785",1
2021-01-01,Região de Saúde Norte,"Hospital de Magalhães Lemos, EPE",0,2200,2200,2021,1,"-8.6649823,41.1764649",1
2021-01-01,Região de Saúde Norte,"Unidade Local de Saúde de Matosinhos, EPE",0,775,775,2021,1,"-8.6745115,41.1794456",1
2021-02-01,Região de Saúde do Alentejo,"Unidade Local de Saúde do Norte Alentejano, EPE",29,28,57,2021,2,"-7.4263845,39.3003425",4
2021-02-01,Região de Saúde do Centro,"Centro Hospitalar Universitário Cova da Beira, EPE",2145,6568,8713,2021,2,"-7.4922407,40.2804158",2
2021-02-01,Região de Saúde LVT,"Centro Hospitalar de Lisboa Ocidental, EPE",15,0,15,2021,2,"-9.216985,38.708454",3
2021-02-01,Região de Saúde Norte,"Centro Hospitalar Universitário de São João, EPE",0,0,0,2021,2,"-8.6010558,41.1831056",1
2021-02-01,Região de Saúde Norte,"Centro Hospitalar do Médio Ave, EPE",7,104,111,2021,2,"-8.4802503,41.3423984",1
2021-02-01,Região de Saúde Norte,"Centro Hospitalar Entre Douro e Vouga, EPE",40,11,51,2021,2,"-8.5458794,40.9293884",1
2021-03-01,Região de Saúde do Centro,"Centro Hospitalar do Baixo Vouga, EPE",115,109,224,2021,3,"-8.6543716,40.6362453",2
2021-03-01,Região de Saúde do Centro,"Centro Hospitalar e Universitário de Coimbra, EPE",7649,52358,60007,2021,3,"-8.4098211,40.2191523",2
2021-03-01,Região de Saúde Norte,"Centro Hospitalar Entre Douro e Vouga, EPE",56,13,69,2021,3,"-8.5458794,40.9293884",1
2021-03-01,Região de Saúde Norte,"Hospital de Braga, EPE",55,0,55,2021,3,"-8.398982,41.56785",1
2021-04-01,Região de Saúde do Centro,"Centro Hospitalar e Universitário de Coimbra, EPE",10577,69421,79998,2021,4,"-8.4098211,40.2191523",2
2021-04-01,Região de Saúde Norte,"Centro Hospitalar Universitário de São João, EPE",0,0,0,2021,4,"-8.6010558,41.1831056",1
2021-04-01,Região de Saúde Norte,"Centro Hospitalar Entre Douro e Vouga, EPE",56,13,69,2021,4,"-8.5458794,40.9293884",1
2021-04-01,Região de Saúde Norte,"Instituto Português Oncologia do Porto, EPE",23,15,38,2021,4,"-8.6062881,41.1785642",1
2021-05-01,Região de Saúde do Alentejo,"Unidade Local de Saúde do Litoral Alentejano, EPE",11,0,11,2021,5,"-8.6956768,38.0162314",4
2021-05-01,Região de Saúde do Alentejo,"Unidade Local de Saúde do Norte Alentejano, EPE",104,67,171,2021,5,"-7.4263845,39.3003425",4
2021-05-01,Região de Saúde LVT,"Centro Hospitalar Barreiro/Montijo, EPE",3,44,47,2021,5,"-9.0592392,38.6554005",3
2021-05-01,Região de Saúde LVT,"Centro Hospitalar Universitário de Lisboa Norte, EPE",1416,362,1778,2021,5,"-9.1616116,38.7500861",3
2021-05-01,Região de Saúde Norte,"Centro Hospitalar Universitário de São João, EPE",0,0,0,2021,5,"-8.6010558,41.1831056",1
2021-05-01,Região de Saúde Norte,"Centro Hospitalar Vila Nova de Gaia/Espinho, EPE",436,0,436,2021,5,"-8.5972617,41.1094138",1
2021-05-01,Região de Saúde Norte,"Hospital de Magalhães Lemos, EPE",0,2200,2200,2021,5,"-8.6649823,41.1764649",1
2021-05-01,Região de Saúde Norte,"Instituto Português Oncologia do Porto, EPE",32,25,57,2021,5,"-8.6062881,41.1785642",1
2021-05-01,Região de Saúde Norte,"Unidade Local de Saúde do Alto Minho, EPE",1,0,1,2021,5,"-8.8252713,41.7056054",1
2021-06-01,Região de Saúde do Alentejo,"Hospital Espírito Santo de Évora, EPE",584,73,657,2021,6,"-7.9032848,38.5684861",4
2021-06-01,Região de Saúde do Alentejo,"Unidade Local de Saúde do Baixo Alentejo, EPE",885,965,1850,2021,6,"-7.8721227,38.014123",4
2021-06-01,Região de Saúde do Alentejo,"Unidade Local de Saúde do Norte Alentejano, EPE",125,79,204,2021,6,"-7.4263845,39.3003425",4
2021-06-01,Região de Saúde LVT,"Centro Hospitalar do Oeste, EPE, EPE",3875,18620,22495,2021,6,"-9.1258493,39.4054629",3
2021-06-01,Região de Saúde LVT,"Centro Hospitalar Universitário de Lisboa Norte, EPE",1758,527,2285,2021,6,"-9.1616116,38.7500861",3
2021-06-01,Região de Saúde LVT,"Centro Hospitalar Médio Tejo, EPE",0,0,0,2021,6,"-8.5404429,39.478072",3
2021-06-01,Região de Saúde Norte,"Centro Hospitalar Universitário do Porto, EPE",1022,0,1022,2021,6,"-8.6172617,41.1472498",1
2021-06-01,Região de Saúde Norte,"Centro Hospitalar Vila Nova de Gaia/Espinho, EPE",511,0,511,2021,6,"-8.5972617,41.1094138",1
2021-06-01,Região de Saúde Norte,"Unidade Local de Saúde de Matosinhos, EPE",0,4795,4795,2021,6,"-8.6745115,41.1794456",1
2021-06-01,Região de Saúde Norte,"Unidade Local de Saúde do Alto Minho, EPE",1,0,1,2021,6,"-8.8252713,41.7056054",1
2021-07-01,Região de Saúde do Alentejo,"Hospital Espírito Santo de Évora, EPE",664,82,746,2021,7,"-7.9032848,38.5684861",4
2021-07-01,Região de Saúde do Alentejo,"Unidade Local de Saúde do Baixo Alentejo, EPE",1068,1064,2132,2021,7,"-7.8721227,38.014123",4
2021-07-01,Região de Saúde do Algarve,"Centro Hospitalar Universitário do Algarve,EPE",0,0,0,2021,7,"-7.9281554,37.0238973",5
2021-07-01,Região de Saúde do Centro,"Centro Hospitalar e Universitário de Coimbra, EPE",19786,85812,105598,2021,7,"-8.4098211,40.2191523",2
2021-07-01,Região de Saúde Norte,"Centro Hospitalar Universitário de São João, EPE",0,0,0,2021,7,"-8.6010558,41.1831056",1
2021-07-01,Região de Saúde Norte,"Centro Hospitalar do Médio Ave, EPE",67,627,694,2021,7,"-8.4802503,41.3423984",1
2021-07-01,Região de Saúde Norte,"Hospital de Braga, EPE",312,0,312,2021,7,"-8.398982,41.56785",1
2021-07-01,Região de Saúde Norte,"Hospital de Magalhães Lemos, EPE",0,2200,2200,2021,7,"-8.6649823,41.1764649",1
2021-07-01,Região de Saúde Norte,"Unidade Local de Saúde de Matosinhos, EPE",0,5583,5583,2021,7,"-8.6745115,41.1794456",1
2021-08-01,Região de Saúde do Alentejo,"Hospital Espírito Santo de Évora, EPE",749,91,840,2021,8,"-7.9032848,38.5684861",4
2021-08-01,Região de Saúde do Algarve,"Centro Hospitalar Universitário do Algarve,EPE",0,0,0,2021,8,"-7.9281554,37.0238973",5
2021-08-01,Região de Saúde do Centro,"Centro Hospitalar de Leiria, EPE",212,151,363,2021,8,"-8.7982706,39.7414812",2
2021-08-01,Região de Saúde LVT,"Centro Hospitalar Barreiro/Montijo, EPE",7,75,82,2021,8,"-9.0592392,38.6554005",3
2021-08-01,Região de Saúde LVT,"Centro Hospitalar de Setúbal, EPE",529,370,899,2021,8,"-8.8818638,38.5283754",3
2021-08-01,Região de Saúde LVT,"Centro Hospitalar Universitário de Lisboa Norte, EPE",2629,632,3261,2021,8,"-9.1616116,38.7500861",3
2021-08-01,Região de Saúde LVT,"Hospital Professor Doutor Fernando Fonseca, EPE",2,65,67,2021,8,"-9.2264834,38.7422257",3
2021-08-01,Região de Saúde Norte,"Centro Hospitalar Universitário do Porto, EPE",1648,0,1648,2021,8,"-8.6172617,41.1472498",1
2021-08-01,Região de Saúde Norte,"Centro Hospitalar Entre Douro e Vouga, EPE",58,13,71,2021,8,"-8.5458794,40.9293884",1
2021-09-01,Região de Saúde do Alentejo,"Hospital Espírito Santo de Évora, EPE",830,105,935,2021,9,"-7.9032848,38.5684861",4
2021-09-01,Região de Saúde do Centro,"Centro Hospitalar de Leiria, EPE",239,169,408,2021,9,"-8.7982706,39.7414812",2
2021-09-01,Região de Saúde do Centro,"Centro Hospitalar do Baixo Vouga, EPE",284,268,552,2021,9,"-8.6543716,40.6362453",2
2021-09-01,Região de Saúde do Centro,"Centro Hospitalar Tondela-Viseu, EPE",171,52,223,2021,9,"-8.0827433,40.516364",2
2021-09-01,Região de Saúde LVT,"Centro Hospitalar Barreiro/Montijo, EPE",9,82,91,2021,9,"-9.0592392,38.6554005",3
2021-09-01,Região de Saúde LVT,"Centro Hospitalar de Setúbal, EPE",598,387,985,2021,9,"-8.8818638,38.5283754",3
2021-09-01,Região de Saúde LVT,"Hospital Garcia de Orta, EPE",533,5270,5803,2021,9,"-9.1822554,38.6658713",3
2021-09-01,Região de Saúde Norte,"Centro Hospitalar Vila Nova de Gaia/Espinho, EPE",959,0,959,2021,9,"-8.5972617,41.1094138",1
2021-09-01,Região de Saúde Norte,"Instituto Português Oncologia do Porto, EPE",76,60,136,2021,9,"-8.6062881,41.1785642",1
2021-10-01,Região de Saúde do Algarve,"Centro Hospitalar Universitário do Algarve,EPE",0,0,0,2021,10,"-7.9281554,37.0238973",5
2021-10-01,Região de Saúde LVT,"Centro Hospitalar Barreiro/Montijo, EPE",9,94,103,2021,10,"-9.0592392,38.6554005",3
2021-10-01,Região de Saúde LVT,"Centro Hospitalar de Lisboa Ocidental, EPE",141,0,141,2021,10,"-9.216985,38.708454",3
2021-10-01,Região de Saúde LVT,Centro Hospitalar Psiquiátrico de Lisboa,470,7686,8156,2021,10,"-9.1460705,38.7569771",3
2021-10-01,Região de Saúde Norte,"Centro Hospitalar do Médio Ave, EPE",97,2114,2211,2021,10,"-8.4802503,41.3423984",1
2021-10-01,Região de Saúde Norte,"Centro Hospitalar Universitário do Porto, EPE",2090,0,2090,2021,10,"-8.6172617,41.1472498",1
2021-10-01,Região de Saúde Norte,"Centro Hospitalar Póvoa de Varzim/Vila do Conde, EPE",438,311,749,2021,10,"-8.7589945,41.3828711",1
2021-10-01,Região de Saúde Norte,"Centro Hospitalar Vila Nova de Gaia/Espinho, EPE",1099,0,1099,2021,10,"-8.5972617,41.1094138",1
2021-10-01,Região de Saúde Norte,"Hospital de Braga, EPE",497,0,497,2021,10,"-8.398982,41.56785",1
2021-11-01,Região de Saúde do Alentejo,"Unidade Local de Saúde do Norte Alentejano, EPE",228,140,368,2021,11,"-7.4263845,39.3003425",4
2021-11-01,Região de Saúde LVT,"Centro Hospitalar de Lisboa Ocidental, EPE",165,0,165,2021,11,"-9.216985,38.708454",3
2021-11-01,Região de Saúde Norte,"Centro Hospitalar Universitário de São João, EPE",0,0,0,2021,11,"-8.6010558,41.1831056",1
2021-12-01,Região de Saúde do Algarve,"Centro Hospitalar Universitário do Algarve,EPE",0,0,0,2021,12,"-7.9281554,37.0238973",5
2021-12-01,Região de Saúde do Centro,"Centro Hospitalar Universitário Cova da Beira, EPE",9830,23221,33051,2021,12,"-7.4922407,40.2804158",2
2021-12-01,Região de Saúde do Centro,"Centro Hospitalar e Universitário de Coimbra, EPE",31425,119546,150971,2021,12,"-8.4098211,40.2191523",2
2021-12-01,Região de Saúde LVT,"Centro Hospitalar de Setúbal, EPE",750,460,1210,2021,12,"-8.8818638,38.5283754",3
2021-12-01,Região de Saúde LVT,Centro Hospitalar Psiquiátrico de Lisboa,584,9193,9777,2021,12,"-9.1460705,38.7569771",3
2021-12-01,Região de Saúde Norte,"Centro Hospitalar Universitário do Porto, EPE",2605,0,2605,2021,12,"-8.6172617,41.1472498",1
2021-12-01,Região de Saúde Norte,"Centro Hospitalar Entre Douro e Vouga, EPE",264,93,357,2021,12,"-8.5458794,40.9293884",1
2021-12-01,Região de Saúde Norte,"Hospital da Senhora da Oliveira, Guimarães, EPE",1293,0,1293,2021,12,"-8.3086907,41.4387173",1
2021-12-01,Região de Saúde Norte,"Unidade Local de Saúde do Alto Minho, EPE",21,17,38,2021,12,"-8.8252713,41.7056054",1
2022-01-01,Região de Saúde do Centro,"Centro Hospitalar Universitário Cova da Beira, EPE",703,1560,2263,2022,1,"-7.4922407,40.2804158",2
2022-01-01,Região de Saúde do Centro,"Centro Hospitalar e Universitário de Coimbra, EPE",245,191,436,2022,1,"-8.4098211,40.2191523",2
2022-01-01,Região de Saúde do Centro,"Centro Hospitalar Tondela-Viseu, EPE",30,8,38,2022,1,"-8.0827433,40.516364",2
2022-01-01,Região de Saúde LVT,"Centro Hospitalar Universitário Lisboa Central, EPE",388,211,599,2022,1,"-9.1371248,38.7166948",3
2022-01-01,Região de Saúde LVT,"Centro Hospitalar de Lisboa Ocidental, EPE",47,157,204,2022,1,"-9.216985,38.708454",3
2022-01-01,Região de Saúde LVT,"Centro Hospitalar de Setúbal, EPE",63,40,103,2022,1,"-8.8818638,38.5283754",3
2022-01-01,Região de Saúde LVT,"Centro Hospitalar Universitário de Lisboa Norte, EPE",418,77,495,2022,1,"-9.1616116,38.7500861",3
2022-01-01,Região de Saúde Norte,"Hospital de Braga, EPE",69,0,69,2022,1,"-8.398982,41.56785",1
2022-01-01,Região de Saúde Norte,"Instituto Português Oncologia do Porto, EPE",14,10,24,2022,1,"-8.6062881,41.1785642",1
2022-01-01,Região de Saúde Norte,"Unidade Local de Saúde de Matosinhos, EPE",0,762,762,2022,1,"-8.6745115,41.1794456",1
2022-02-01,Região de Saúde do Centro,"Centro Hospitalar Tondela-Viseu, EPE",62,23,85,2022,2,"-8.0827433,40.516364",2
2022-02-01,Região de Saúde do Centro,Hospital Arcebispo João Crisóstomo,5,0,5,2022,2,"-8.5933462,40.3470015",2
2022-02-01,Região de Saúde Norte,"Centro Hospitalar Vila Nova de Gaia/Espinho, EPE",131,0,131,2022,2,"-8.5972617,41.1094138",1
2022-03-01,Região de Saúde do Alentejo,"Unidade Local de Saúde do Baixo Alentejo, EPE",548,327,875,2022,3,"-7.8721227,38.014123",4
2022-03-01,Região de Saúde do Algarve,"Centro Hospitalar Universitário do Algarve,EPE",0,0,0,2022,3,"-7.9281554,37.0238973",5
2022-03-01,Região de Saúde LVT,"Centro Hospitalar Barreiro/Montijo, EPE",335,293,628,2022,3,"-9.0592392,38.6554005",3
2022-03-01,Região de Saúde LVT,"Centro Hospitalar Médio Tejo, EPE",0,0,0,2022,3,"-8.5404429,39.478072",3
2022-03-01,Região de Saúde Norte,"Centro Hospitalar Vila Nova de Gaia/Espinho, EPE",182,0,182,2022,3,"-8.5972617,41.1094138",1
2022-03-01,Região de Saúde Norte,"Hospital da Senhora da Oliveira, Guimarães, EPE",324,0,324,2022,3,"-8.3086907,41.4387173",1
2022-04-01,Região de Saúde do Alentejo,"Hospital Espírito Santo de Évora, EPE",470,61,531,2022,4,"-7.9032848,38.5684861",4
2022-04-01,Região de Saúde do Alentejo,"Unidade Local de Saúde do Norte Alentejano, EPE",280,27,307,2022,4,"-7.4263845,39.3003425",4
2022-04-01,Região de Saúde do Centro,Hospital Arcebispo João Crisóstomo,19,0,19,2022,4,"-8.5933462,40.3470015",2
2022-04-01,Região de Saúde LVT,"Centro Hospitalar Universitário Lisboa Central, EPE",626,1080,1706,2022,4,"-9.1371248,38.7166948",3
2022-04-01,Região de Saúde LVT,"Centro Hospitalar Médio Tejo, EPE",0,0,0,2022,4,"-8.5404429,39.478072",3
2022-04-01,Região de Saúde Norte,"Centro Hospitalar do Médio Ave, EPE",64,1652,1716,2022,4,"-8.4802503,41.3423984",1
2022-04-01,Região de Saúde Norte,"Instituto Português Oncologia do Porto, EPE",41,60,101,2022,4,"-8.6062881,41.1785642",1
2022-05-01,Região de Saúde do Alentejo,"Unidade Local de Saúde do Baixo Alentejo, EPE",894,444,1338,2022,5,"-7.8721227,38.014123",4
2022-05-01,Região de Saúde do Alentejo,"Unidade Local de Saúde do Norte Alentejano, EPE",335,51,386,2022,5,"-7.4263845,39.3003425",4
2022-05-01,Região de Saúde do Centro,"Centro Hospitalar e Universitário de Coimbra, EPE",1119,1079,2198,2022,5,"-8.4098211,40.2191523",2
2022-05-01,Região de Saúde do Centro,Centro Medicina de Reabilitação da Região Centro Rovisco Pais,22,2,24,2022,5,"-8.7707806,40.297919",2
2022-05-01,Região de Saúde do Centro,"Unidade Local de Saúde de Castelo Branco, EPE",1957,2455,4412,2022,5,"-7.4981271,39.8212263",2
2022-05-01,Região de Saúde LVT,"Centro Hospitalar do Oeste, EPE, EPE",4534,8399,12933,2022,5,"-9.1258493,39.4054629",3
2022-05-01,Região de Saúde Norte,"Centro Hospitalar Universitário de São João, EPE",0,0,0,2022,5,"-8.6010558,41.1831056",1
2022-05-01,Região de Saúde Norte,"Centro Hospitalar do Médio Ave, EPE",86,2096,2182,2022,5,"-8.4802503,41.3423984",1
2022-05-01,Região de Saúde Norte,"Centro Hospitalar Entre Douro e Vouga, EPE",64,45,109,2022,5,"-8.5458794,40.9293884",1
2022-05-01,Região de Saúde Norte,"Hospital da Senhora da Oliveira, Guimarães, EPE",552,0,552,2022,5,"-8.3086907,41.4387173",1
2022-06-01,Região de Saúde do Algarve,"Centro Hospitalar Universitário do Algarve,EPE",0,0,0,2022,6,"-7.9281554,37.0238973",5
2022-06-01,Região de Saúde do Centro,Centro Medicina de Reabilitação da Região Centro Rovisco Pais,28,5,33,2022,6,"-8.7707806,40.297919",2
2022-06-01,Região de Saúde LVT,"Centro Hospitalar Universitário Lisboa Central, EPE",700,1755,2455,2022,6,"-9.1371248,38.7166948",3
2022-06-01,Região de Saúde LVT,"Centro Hospitalar de Lisboa Ocidental, EPE",142,1024,1166,2022,6,"-9.216985,38.708454",3
2022-06-01,Região de Saúde LVT,"Centro Hospitalar Médio Tejo, EPE",0,0,0,2022,6,"-8.5404429,39.478072",3
2022-06-01,Região de Saúde LVT,"Hospital Distrital de Santarém, EPE",1,38,39,2022,6,"-8.6937515,39.2410946",3
2022-06-01,Região de Saúde Norte,"Centro Hospitalar Universitário do Porto, EPE",1581,0,1581,2022,6,"-8.6172617,41.1472498",1
2022-06-01,Região de Saúde Norte,"Hospital da Senhora da Oliveira, Guimarães, EPE",604,0,604,2022,6,"-8.3086907,41.4387173",1
2022-06-01,Região de Saúde Norte,"Hospital de Magalhães Lemos, EPE",0,1465,1465,2022,6,"-8.6649823,41.1764649",1
2022-07-01,Região de Saúde do Alentejo,"Unidade Local de Saúde do Norte Alentejano, EPE",415,89,504,2022,7,"-7.4263845,39.3003425",4
2022-07-01,Região de Saúde do Centro,"Hospital Distrital da Figueira da Foz, EPE",1510,2444,3954,2022,7,"-8.8586755,40.117897",2
2022-07-01,Região de Saúde do Centro,"Unidade Local de Saúde de Castelo Branco, EPE",2631,2890,5521,2022,7,"-7.4981271,39.8212263",2
2022-07-01,Região de Saúde LVT,"Centro Hospitalar Barreiro/Montijo, EPE",929,1418,2347,2022,7,"-9.0592392,38.6554005",3
2022-07-01,Região de Saúde LVT,"Centro Hospitalar Universitário Lisboa Central, EPE",769,2092,2861,2022,7,"-9.1371248,38.7166948",3
2022-07-01,Região de Saúde LVT,"Centro Hospitalar do Oeste, EPE, EPE",6012,10912,16924,2022,7,"-9.1258493,39.4054629",3
2022-07-01,Região de Saúde Norte,"Centro Hospitalar Entre Douro e Vouga, EPE",70,71,141,2022,7,"-8.5458794,40.9293884",1
2022-07-01,Região de Saúde Norte,"Centro Hospitalar Póvoa de Varzim/Vila do Conde, EPE",285,6,291,2022,7,"-8.7589945,41.3828711",1
2022-07-01,Região de Saúde Norte,"Centro Hospitalar Vila Nova de Gaia/Espinho, EPE",415,0,415,2022,7,"-8.5972617,41.1094138",1
2022-08-01,Região de Saúde do Centro,"Centro Hospitalar Universitário Cova da Beira, EPE",4316,11102,15418,2022,8,"-7.4922407,40.2804158",2
2022-08-01,Região de Saúde do Centro,"Centro Hospitalar de Leiria, EPE",200,131,331,2022,8,"-8.7982706,39.7414812",2
2022-08-01,Região de Saúde do Centro,"Centro Hospitalar Tondela-Viseu, EPE",186,76,262,2022,8,"-8.0827433,40.516364",2
2022-08-01,Região de Saúde do Centro,Centro Medicina de Reabilitação da Região Centro Rovisco Pais,41,6,47,2022,8,"-8.7707806,40.297919",2
2022-08-01,Região de Saúde LVT,"Hospital Distrital de Santarém, EPE",4,52,56,2022,8,"-8.6937515,39.2410946",3
2022-08-01,Região de Saúde LVT,"Hospital Professor Doutor Fernando Fonseca, EPE",2581,23003,25584,2022,8,"-9.2264834,38.7422257",3
2022-08-01,Região de Saúde Norte,"Centro Hospitalar do Médio Ave, EPE",145,3089,3234,2022,8,"-8.4802503,41.3423984",1
2022-08-01,Região de Saúde Norte,"Centro Hospitalar Entre Douro e Vouga, EPE",70,72,142,2022,8,"-8.5458794,40.9293884",1
2022-08-01,Região de Saúde Norte,"Centro Hospitalar Póvoa de Varzim/Vila do Conde, EPE",330,6,336,2022,8,"-8.7589945,41.3828711",1
2022-08-01,Região de Saúde Norte,"Centro Hospitalar Vila Nova de Gaia/Espinho, EPE",511,0,511,2022,8,"-8.5972617,41.1094138",1
2022-08-01,Região de Saúde Norte,"Instituto Português Oncologia do Porto, EPE",90,104,194,2022,8,"-8.6062881,41.1785642",1
2022-09-01,Região de Saúde do Alentejo,"Unidade Local de Saúde do Litoral Alentejano, EPE",17,0,17,2022,9,"-8.6956768,38.0162314",4
2022-09-01,Região de Saúde do Algarve,"Centro Hospitalar Universitário do Algarve,EPE",0,0,0,2022,9,"-7.9281554,37.0238973",5
2022-09-01,Região de Saúde do Centro,"Centro Hospitalar e Universitário de Coimbra, EPE",1896,1897,3793,2022,9,"-8.4098211,40.2191523",2
2022-09-01,Região de Saúde do Centro,Centro Medicina de Reabilitação da Região Centro Rovisco Pais,42,8,50,2022,9,"-8.7707806,40.297919",2
2022-09-01,Região de Saúde LVT,"Centro Hospitalar do Oeste, EPE, EPE",7070,13350,20420,2022,9,"-9.1258493,39.4054629",3
2022-09-01,Região de Saúde LVT,"Hospital Professor Doutor Fernando Fonseca, EPE",2931,25561,28492,2022,9,"-9.2264834,38.7422257",3
2022-09-01,Região de Saúde Norte,"Centro Hospitalar Póvoa de Varzim/Vila do Conde, EPE",387,6,393,2022,9,"-8.7589945,41.3828711",1
2022-09-01,Região de Saúde Norte,"Hospital de Braga, EPE",616,0,616,2022,9,"-8.398982,41.56785",1
2022-10-01,Região de Saúde do Alentejo,"Unidade Local de Saúde do Litoral Alentejano, EPE",17,0,17,2022,10,"-8.6956768,38.0162314",4
2022-10-01,Região de Saúde do Centro,"Centro Hospitalar de Leiria, EPE",263,185,448,2022,10,"-8.7982706,39.7414812",2
2022-10-01,Região de Saúde LVT,"Centro Hospitalar de Lisboa Ocidental, EPE",211,1589,1800,2022,10,"-9.216985,38.708454",3
2022-10-01,Região de Saúde LVT,"Centro Hospitalar do Oeste, EPE, EPE",7688,14804,22492,2022,10,"-9.1258493,39.4054629",3
2022-10-01,Região de Saúde LVT,"Centro Hospitalar Universitário de Lisboa Norte, EPE",5689,506,6195,2022,10,"-9.1616116,38.7500861",3
2022-10-01,Região de Saúde LVT,Centro Hospitalar Psiquiátrico de Lisboa,385,6955,7340,2022,10,"-9.1460705,38.7569771",3
2022-10-01,Região de Saúde Norte,"Centro Hospitalar do Médio Ave, EPE",192,3900,4092,2022,10,"-8.4802503,41.3423984",1
2022-10-01,Região de Saúde Norte,"Hospital da Senhora da Oliveira, Guimarães, EPE",760,0,760,2022,10,"-8.3086907,41.4387173",1
2022-10-01,Região de Saúde Norte,"Hospital de Braga, EPE",649,0,649,2022,10,"-8.398982,41.56785",1
2022-10-01,Região de Saúde Norte,"Hospital de Magalhães Lemos, EPE",0,2444,2444,2022,10,"-8.6649823,41.1764649",1
2022-11-01,Região de Saúde do Centro,"Centro Hospitalar de Leiria, EPE",273,204,477,2022,11,"-8.7982706,39.7414812",2
2022-11-01,Região de Saúde do Centro,"Centro Hospitalar e Universitário de Coimbra, EPE",2993,2527,5520,2022,11,"-8.4098211,40.2191523",2
2022-11-01,Região de Saúde LVT,"Centro Hospitalar Barreiro/Montijo, EPE",1590,2370,3960,2022,11,"-9.0592392,38.6554005",3
2022-11-01,Região de Saúde LVT,"Centro Hospitalar de Lisboa Ocidental, EPE",239,1758,1997,2022,11,"-9.216985,38.708454",3
2022-11-01,Região de Saúde LVT,"Hospital Distrital de Santarém, EPE",7,97,104,2022,11,"-8.6937515,39.2410946",3
2022-11-01,Região de Saúde Norte,"Centro Hospitalar Universitário de São João, EPE",0,0,0,2022,11,"-8.6010558,41.1831056",1
2022-12-01,Região de Saúde do Alentejo,"Unidade Local de Saúde do Norte Alentejano, EPE",634,299,933,2022,12,"-7.4263845,39.3003425",4
2022-12-01,Região de Saúde do Algarve,"Centro Hospitalar Universitário do Algarve,EPE",0,0,0,2022,12,"-7.9281554,37.0238973",5
2022-12-01,Região de Saúde do Centro,Centro Medicina de Reabilitação da Região Centro Rovisco Pais,64,14,78,2022,12,"-8.7707806,40.297919",2
2022-12-01,Região de Saúde do Centro,"Instituto Português Oncologia de Coimbra, EPE",0,24,24,2022,12,"-8.4103814,40.2162514",2
2022-12-01,Região de Saúde LVT,"Centro Hospitalar de Setúbal, EPE",576,784,1360,2022,12,"-8.8818638,38.5283754",3
2022-12-01,Região de Saúde LVT,"Centro Hospitalar Médio Tejo, EPE",0,0,0,2022,12,"-8.5404429,39.478072",3
2022-12-01,Região de Saúde Norte,"Centro Hospitalar do Médio Ave, EPE",243,4727,4970,2022,12,"-8.4802503,41.3423984",1
2022-12-01,Região de Saúde Norte,"Centro Hospitalar Póvoa de Varzim/Vila do Conde, EPE",485,54,539,2022,12,"-8.7589945,41.3828711",1
2022-12-01,Região de Saúde Norte,"Unidade Local de Saúde de Matosinhos, EPE",0,8235,8235,2022,12,"-8.6745115,41.1794456",1
2023-01-01,Região de Saúde do Alentejo,"Unidade Local de Saúde do Litoral Alentejano, EPE",3,5,8,2023,1,"-8.6956768,38.0162314",4
2023-01-01,Região de Saúde do Algarve,"Centro Hospitalar Universitário do Algarve,EPE",0,0,0,2023,1,"-7.9281554,37.0238973",5
2023-01-01,Região de Saúde do Centro,"Centro Hospitalar do Baixo Vouga, EPE",54,54,108,2023,1,"-8.6543716,40.6362453",2
2023-01-01,Região de Saúde LVT,"Centro Hospitalar Barreiro/Montijo, EPE",253,247,500,2023,1,"-9.0592392,38.6554005",3
2023-01-01,Região de Saúde LVT,"Hospital de Vila Franca de Xira, EPE",15,0,15,2023,1,"-8.984506,38.977235",3
2023-01-01,Região de Saúde Norte,"Centro Hospitalar Entre Douro e Vouga, EPE",6,17,23,2023,1,"-8.5458794,40.9293884",1
2023-02-01,Região de Saúde do Alentejo,"Unidade Local de Saúde do Baixo Alentejo, EPE",84,109,193,2023,2,"-7.8721227,38.014123",4
2023-02-01,Região de Saúde do Alentejo,"Unidade Local de Saúde do Norte Alentejano, EPE",36,189,225,2023,2,"-7.4263845,39.3003425",4
2023-02-01,Região de Saúde do Centro,"Centro Hospitalar Tondela-Viseu, EPE",62,19,81,2023,2,"-8.0827433,40.516364",2
2023-02-01,Região de Saúde LVT,Centro Hospitalar Psiquiátrico de Lisboa,100,1259,1359,2023,2,"-9.1460705,38.7569771",3
2023-02-01,Região de Saúde Norte,"Centro Hospitalar Universitário de São João, EPE",0,0,0,2023,2,"-8.6010558,41.1831056",1
2023-03-01,Região de Saúde do Centro,"Centro Hospitalar de Leiria, EPE",86,98,184,2023,3,"-8.7982706,39.7414812",2
2023-03-01,Região de Saúde do Centro,"Hospital Distrital da Figueira da Foz, EPE",254,647,901,2023,3,"-8.8586755,40.117897",2
2023-03-01,Região de Saúde LVT,"Centro Hospitalar Barreiro/Montijo, EPE",821,895,1716,2023,3,"-9.0592392,38.6554005",3
2023-03-01,Região de Saúde LVT,"Centro Hospitalar do Oeste, EPE, EPE",1025,2658,3683,2023,3,"-9.1258493,39.4054629",3
2023-03-01,Região de Saúde LVT,"Hospital Distrital de Santarém, EPE",1,44,45,2023,3,"-8.6937515,39.2410946",3
2023-03-01,Região de Saúde Norte,"Hospital da Senhora da Oliveira, Guimarães, EPE",326,0,326,2023,3,"-8.3086907,41.4387173",1
2023-04-01,Região de Saúde do Alentejo,"Hospital Espírito Santo de Évora, EPE",361,82,443,2023,4,"-7.9032848,38.5684861",4
2023-04-01,Região de Saúde do Centro,"Centro Hospitalar e Universitário de Coimbra, EPE",2430,1071,3501,2023,4,"-8.4098211,40.2191523",2
2023-04-01,Região de Saúde do Centro,Centro Medicina de Reabilitação da Região Centro Rovisco Pais,71,35,106,2023,4,"-8.7707806,40.297919",2
2023-04-01,Região de Saúde LVT,"Centro Hospitalar Universitário Lisboa Central, EPE",463,1877,2340,2023,4,"-9.1371248,38.7166948",3
2023-04-01,Região de Saúde Norte,"Centro Hospitalar do Médio Ave, EPE",84,1736,1820,2023,4,"-8.4802503,41.3423984",1
2023-04-01,Região de Saúde Norte,"Hospital da Senhora da Oliveira, Guimarães, EPE",408,0,408,2023,4,"-8.3086907,41.4387173",1
2023-04-01,Região de Saúde Norte,"Hospital de Braga, EPE",216,0,216,2023,4,"-8.398982,41.56785",1
2023-05-01,Região de Saúde do Alentejo,"Unidade Local de Saúde do Baixo Alentejo, EPE",176,271,447,2023,5,"-7.8721227,38.014123",4
2023-05-01,Região de Saúde do Centro,"Centro Hospitalar Universitário Cova da Beira, EPE",1962,5898,7860,2023,5,"-7.4922407,40.2804158",2
2023-05-01,Região de Saúde do Centro,"Centro Hospitalar de Leiria, EPE",139,142,281,2023,5,"-8.7982706,39.7414812",2
2023-05-01,Região de Saúde do Centro,"Centro Hospitalar Tondela-Viseu, EPE",169,45,214,2023,5,"-8.0827433,40.516364",2
2023-05-01,Região de Saúde do Centro,Hospital Arcebispo João Crisóstomo,12,0,12,2023,5,"-8.5933462,40.3470015",2
2023-05-01,Região de Saúde do Centro,"Instituto Português Oncologia de Coimbra, EPE",0,11,11,2023,5,"-8.4103814,40.2162514",2
2023-05-01,Região de Saúde do Centro,"Unidade Local de Saúde de Castelo Branco, EPE",1453,2336,3789,2023,5,"-7.4981271,39.8212263",2
2023-05-01,Região de Saúde LVT,"Centro Hospitalar Universitário Lisboa Central, EPE",651,2618,3269,2023,5,"-9.1371248,38.7166948",3
2023-05-01,Região de Saúde Norte,"Centro Hospitalar Entre Douro e Vouga, EPE",84,59,143,2023,5,"-8.5458794,40.9293884",1
2023-05-01,Região de Saúde Norte,"Centro Hospitalar Universitário de Santo António, EPE",962,982,1944,2023,5,"-8.6172617,41.1472498",1
2023-05-01,Região de Saúde Norte,"Instituto Português Oncologia do Porto, EPE",75,83,158,2023,5,"-8.6062881,41.1785642",1
2023-06-01,Região de Saúde do Centro,"Centro Hospitalar do Baixo Vouga, EPE",270,278,548,2023,6,"-8.6543716,40.6362453",2
2023-06-01,Região de Saúde do Centro,"Unidade Local de Saúde de Castelo Branco, EPE",1749,2731,4480,2023,6,"-7.4981271,39.8212263",2
2023-06-01,Região de Saúde LVT,"Centro Hospitalar de Lisboa Ocidental, EPE",142,1243,1385,2023,6,"-9.216985,38.708454",3
2023-06-01,Região de Saúde LVT,"Hospital Garcia de Orta, EPE",333,5462,5795,2023,6,"-9.1822554,38.6658713",3
2023-06-01,Região de Saúde Norte,"Centro Hospitalar Universitário de São João, EPE",0,0,0,2023,6,"-8.6010558,41.1831056",1
2023-06-01,Região de Saúde Norte,"Centro Hospitalar Póvoa de Varzim/Vila do Conde, EPE",234,36,270,2023,6,"-8.7589945,41.3828711",1
2023-06-01,Região de Saúde Norte,"Centro Hospitalar Vila Nova de Gaia/Espinho, EPE",173,0,173,2023,6,"-8.5972617,41.1094138",1
2023-06-01,Região de Saúde Norte,"Unidade Local de Saúde de Matosinhos, EPE",0,4105,4105,2023,6,"-8.6745115,41.1794456",1
2023-07-01,Região de Saúde do Algarve,"Centro Hospitalar Universitário do Algarve,EPE",0,0,0,2023,7,"-7.9281554,37.0238973",5
2023-07-01,Região de Saúde do Centro,"Centro Hospitalar de Leiria, EPE",176,187,363,2023,7,"-8.7982706,39.7414812",2
2023-07-01,Região de Saúde do Centro,"Centro Hospitalar do Baixo Vouga, EPE",286,303,589,2023,7,"-8.6543716,40.6362453",2
2023-07-01,Região de Saúde do Centro,"Centro Hospitalar e Universitário de Coimbra, EPE",4172,2047,6219,2023,7,"-8.4098211,40.2191523",2
2023-07-01,Região de Saúde do Centro,"Instituto Português Oncologia de Coimbra, EPE",0,15,15,2023,7,"-8.4103814,40.2162514",2
2023-07-01,Região de Saúde LVT,"Centro Hospitalar do Oeste, EPE, EPE",1923,5482,7405,2023,7,"-9.1258493,39.4054629",3
2023-07-01,Região de Saúde Norte,"Centro Hospitalar Universitário de São João, EPE",0,0,0,2023,7,"-8.6010558,41.1831056",1
2023-08-01,Região de Saúde do Alentejo,"Unidade Local de Saúde do Baixo Alentejo, EPE",240,519,759,2023,8,"-7.8721227,38.014123",4
2023-08-01,Região de Saúde do Centro,"Centro Hospitalar de Leiria, EPE",188,214,402,2023,8,"-8.7982706,39.7414812",2
2023-08-01,Região de Saúde do Centro,"Centro Hospitalar Tondela-Viseu, EPE",299,72,371,2023,8,"-8.0827433,40.516364",2
2023-08-01,Região de Saúde do Centro,Centro Medicina de Reabilitação da Região Centro Rovisco Pais,139,59,198,2023,8,"-8.7707806,40.297919",2
2023-08-01,Região de Saúde LVT,"Centro Hospitalar de Setúbal, EPE",111,309,420,2023,8,"-8.8818638,38.5283754",3
2023-08-01,Região de Saúde LVT,"Centro Hospitalar Médio Tejo, EPE",0,0,0,2023,8,"-8.5404429,39.478072",3
2023-08-01,Região de Saúde LVT,Centro Hospitalar Psiquiátrico de Lisboa,322,4459,4781,2023,8,"-9.1460705,38.7569771",3
2023-08-01,Região de Saúde LVT,"Hospital Distrital de Santarém, EPE",11,784,795,2023,8,"-8.6937515,39.2410946",3
2023-08-01,Região de Saúde Norte,"Centro Hospitalar do Médio Ave, EPE",188,3241,3429,2023,8,"-8.4802503,41.3423984",1
2023-08-01,Região de Saúde Norte,"Centro Hospitalar Trás-os-Montes e Alto Douro, EPE",177,0,177,2023,8,"-7.7515252,41.3031784",1
2023-09-01,Região de Saúde do Centro,"Centro Hospitalar Tondela-Viseu, EPE",336,90,426,2023,9,"-8.0827433,40.516364",2
2023-09-01,Região de Saúde do Centro,"Unidade Local de Saúde de Castelo Branco, EPE",2496,3796,6292,2023,9,"-7.4981271,39.8212263",2
2023-09-01,Região de Saúde LVT,"Centro Hospitalar de Lisboa Ocidental, EPE",201,1921,2122,2023,9,"-9.216985,38.708454",3
2023-09-01,Região de Saúde LVT,"Hospital Distrital de Santarém, EPE",136,76,212,2023,9,"-8.6937515,39.2410946",3
2023-09-01,Região de Saúde LVT,"Hospital Garcia de Orta, EPE",442,7863,8305,2023,9,"-9.1822554,38.6658713",3
2023-09-01,Região de Saúde Norte,"Centro Hospitalar Universitário de São João, EPE",0,0,0,2023,9,"-8.6010558,41.1831056",1
2023-09-01,Região de Saúde Norte,"Centro Hospitalar Póvoa de Varzim/Vila do Conde, EPE",383,64,447,2023,9,"-8.7589945,41.3828711",1
2023-09-01,Região de Saúde Norte,"Centro Hospitalar Vila Nova de Gaia/Espinho, EPE",257,0,257,2023,9,"-8.5972617,41.1094138",1
2023-09-01,Região de Saúde Norte,"Instituto Português Oncologia do Porto, EPE",123,146,269,2023,9,"-8.6062881,41.1785642",1
2023-09-01,Região de Saúde Norte,"Unidade Local de Saúde de Matosinhos, EPE",0,6062,6062,2023,9,"-8.6745115,41.1794456",1
2023-10-01,Região de Saúde do Centro,"Centro Hospitalar do Baixo Vouga, EPE",394,411,805,2023,10,"-8.6543716,40.6362453",2
2023-10-01,Região de Saúde LVT,"Centro Hospitalar Universitário de Lisboa Norte, EPE",5728,57,5785,2023,10,"-9.1616116,38.7500861",3
2023-10-01,Região de Saúde Norte,"Centro Hospitalar Universitário de São João, EPE",0,0,0,2023,10,"-8.6010558,41.1831056",1
2023-10-01,Região de Saúde Norte,"Centro Hospitalar Vila Nova de Gaia/Espinho, EPE",283,0,283,2023,10,"-8.5972617,41.1094138",1
2023-11-01,Região de Saúde do Algarve,"Centro Hospitalar Universitário do Algarve,EPE",0,0,0,2023,11,"-7.9281554,37.0238973",5
2023-11-01,Região de Saúde do Centro,Centro Medicina de Reabilitação da Região Centro Rovisco Pais,212,89,301,2023,11,"-8.7707806,40.297919",2
2023-11-01,Região de Saúde LVT,"Centro Hospitalar Barreiro/Montijo, EPE",2536,3138,5674,2023,11,"-9.0592392,38.6554005",3
2023-11-01,Região de Saúde LVT,"Centro Hospitalar de Setúbal, EPE",157,585,742,2023,11,"-8.8818638,38.5283754",3
2023-11-01,Região de Saúde LVT,"Hospital Garcia de Orta, EPE",539,9771,10310,2023,11,"-9.1822554,38.6658713",3
2023-11-01,Região de Saúde Norte,"Hospital da Senhora da Oliveira, Guimarães, EPE",1030,0,1030,2023,11,"-8.3086907,41.4387173",1
2023-11-01,Região de Saúde Norte,"Unidade Local de Saúde de Matosinhos, EPE",0,7455,7455,2023,11,"-8.6745115,41.1794456",1
2023-12-01,Região de Saúde do Alentejo,"Hospital Espírito Santo de Évora, EPE",868,240,1108,2023,12,"-7.9032848,38.5684861",4
2023-12-01,Região de Saúde do Alentejo,"Unidade Local de Saúde do Norte Alentejano, EPE",882,718,1600,2023,12,"-7.4263845,39.3003425",4
2023-12-01,Região de Saúde do Centro,"Centro Hospitalar de Leiria, EPE",289,289,578,2023,12,"-8.7982706,39.7414812",2
2023-12-01,Região de Saúde do Centro,"Hospital Distrital da Figueira da Foz, EPE",963,2436,3399,2023,12,"-8.8586755,40.117897",2
2023-12-01,Região de Saúde LVT,"Centro Hospitalar Barreiro/Montijo, EPE",2719,3381,6100,2023,12,"-9.0592392,38.6554005",3
2023-12-01,Região de Saúde LVT,"Centro Hospitalar Universitário Lisboa Central, EPE",2259,17952,20211,2023,12,"-9.1371248,38.7166948",3
2023-12-01,Região de Saúde LVT,"Centro Hospitalar Universitário de Lisboa Norte, EPE",7375,76,7451,2023,12,"-9.1616116,38.7500861",3
2023-12-01,Região de Saúde Norte,"Centro Hospitalar Universitário de São João, EPE",0,0,0,2023,12,"-8.6010558,41.1831056",1
2023-12-01,Região de Saúde Norte,"Centro Hospitalar Trás-os-Montes e Alto Douro, EPE",268,0,268,2023,12,"-7.7515252,41.3031784",1
2023-12-01,Região de Saúde Norte,"Hospital da Senhora da Oliveira, Guimarães, EPE",1110,0,1110,2023,12,"-8.3086907,41.4387173",1
2023-12-01,Região de Saúde Norte,"Hospital de Braga, EPE",563,0,563,2023,12,"-8.398982,41.56785",1
